ᎤᎭ	ù:ha	He has something solid
ᎡᏥ	e:ji	Mother
ᎡᎦ	é:ga	He is going
ᏨᏌ	jv̌:sa	Your one self
ᏦᎩᏘᏗ	jò:gì:tdi	For them and me to bake things
ᏣᎪᏗ	jakóhdi	For him to have you (1)
ᏓᏋᏯ	dà:gwù:wâ:ya	I have rod shaped things
ᏓᏂᏰᎠ	dà:ni:hyé:ɂa	They are eating flexible things
ᎭᏓᎪᏩᏔ	hada:gò:wahta	Let you (1) see yourself
ᎠᎪᎵᎦ	à:go:lì:ga	He is being recognized
ᎨᏦᎵᏍᏗ	ge:jo:hlísdi	For them to recognize you (1)
ᏓᎪᏩᏔ	dagò:wahtā	He recently saw them
ᏫᏦᏥᏟᏌ	wijò:jì:hlǐ:sa	Let them and me gather things
ᏫᏗᎪᎵᎩ	widigo:lì:gi	Let me understand things
ᏍᏓᏓᎪᎲᎢ	sdada:go:hv̌:ɂi	You both saw yourselves a while ago
ᏧᏤᎵᎢ	juje:li̋:ɂi	His things
ᏔᏚᎩ	tatǔ:gi	Let you (1) drink alcoholic drinks
ᏗᎩᎾᏓᏚᎳ	diginadadǔ:la	Let you (1) and me want each other
ᏕᎭᏚᎦ	de:hatǔ:gā	You (1) recently drank alcoholic drinks
ᎨᎦᏚᎳ	ge:gadǔ:lā	They recently wanted all of us; They were recently wanted
ᏚᎭ	du:ha	He has solid things
ᎨᎦ	gé:ga	I am going
ᏧᏂᏘᏗ	jù:nì:tdi	For them to bake things
ᎠᏋᏌ	à:gwv̌:sa	Myself
ᏕᏨᏯ	de:jù:wâ:ya	You (1) have rod shaped things
ᏕᏂᏰᎠ	dé:ni:hyé:ɂa	You (1) and I are eating flexible things
ᎢᎾᏓᎪᏩᏔ	ì:nada:gò:wahta	Let you (1) and me see ourselves
ᎡᎪᎵᎦ	è:go:lì:ga	All of us are being recognized
ᎠᏓᎪᏩᏔ	à:da:gò:wahtā	He recently saw himself
ᏫᏗᏂᏟᏌ	widinì:hlǐ:sa	Let them gather things
ᏦᎦᏓᏙᎵᏍᏗ	jò:gada:do:hlísdi	For them and me to be acquainted
ᏕᎦᏓᎪᎲᎢ	dé:gada:go:hv̌:ɂi	All of us saw each other a while ago
ᏗᏣᏤᎵᎢ	dijaje:li̋:ɂi	Your things; You all, your things
ᏗᏓᏚᎩ	didatǔ:gi	Let all of us drink alcoholic drinks
ᎪᎦᏚᎳ	go:gadǔ:lā	They recently wanted them and me
ᎢᎩᎭ	ì:gi:ha	All of us have something solid
ᎮᎦ	hé:ga	You (1) are going
ᏗᎩᏘᏗ	digì:tdi	For all of us to bake things
ᏕᏗᏰᎠ	dé:di:hyé:ɂa	All of us are eating flexible things
ᏍᎩᎪᏗ	sgikóhdi	For you (1) to have me
ᎢᏓᏓᎪᏩᏔ	ì:dada:gò:wahta	Let all of us see ourselves
ᎡᏃᎵᎦ	è:no:lì:ga	You (1) and I recognize him
ᎦᏓᎪᏩᏔ	gada:gò:wahtā	I recently saw myself
ᏫᏦᏍᏗᏟᏌ	wijò:sdì:hlǐ:sa	Let him and me gather things
ᏧᎾᏓᏙᎵᏍᏗ	jù:nada:do:hlísdi	For them to be acquainted
ᏕᏣᏓᎪᎲᎢ	dé:jada:go:hv̌:ɂi	You all saw each other a while ago
ᏗᏣᏚᎩ	dijatǔ:gi	Let you all drink alcoholic drinks
ᎬᏆᏚᎳ	gv:gwadǔ:lā	They recently wanted me
ᎣᎩᎭ	ò:gi:ha	They and I have something solid
ᏍᏕᎦ	sdé:ga	You both are going
ᏙᏥᏰᎠ	dò:ji:hyé:ɂa	They and I are eating flexible things
ᏗᏍᏗᏘᏗ	disdì:tdi	For you both to bake things
ᎡᏣᎪᏗ	è:jakóhdi	For someone to have you (1)
ᏗᎾᏓᎪᏩᏔ	dinada:gò:wahta	Let you (1) and me see each other
ᎡᏙᎵᎦ	è:do:lì:ga	All of us recognize him
ᏙᎦᏓᎪᎲᎢ	dò:gada:go:hv̌:ɂi	They and I saw each other a while ago
ᎠᎾᏓᎪᏩᏔ	à:nada:gò:wahtā	They recently saw themselves
ᏦᎩᎾᏓᏙᎵᏍᏗ	jò:ginada:do:hlísdi	For him and me to be acquainted
ᏗᎾᏚᎩ	dínatǔ:gi	Let you (1) and me drink alcoholic drinks
ᎨᎩᎾᏚᎳ	ge:ginadǔ:lā	They recently wanted you (1) and me
ᎤᏂᎭ	ù:ni:ha	They have something solid
ᏗᎩᏘᏗ	dìgìtdi	For me to bake things
ᏙᏍᏗᏰᎠ	dò:sdi:hyé:ɂa	He and I are eating flexible things
ᎥᎩᎪᏗ	v̀:gikóhdi	For someone to have me
ᏗᏓᏓᎪᏩᏔ	didada:gò:wahta	Let all of us see each other
ᎡᏦᎵᎦ	è:jo:lì:ga	You all recognize him; You all are being recognized
ᏚᎾᏓᎪᎲᎢ	dù:nada:go:hv̌:ɂi	They saw each other a while ago
ᎣᏣᏓᎪᏩᏔ	ò:jada:gò:wahtā	They and I recently saw ourselves
ᏫᏓᏚᎩ	widatǔ:gi	Let him drink alcoholic drinks
ᎪᎩᎾᏚᎳ	go:ginadǔ:lā	They recently wanted him and me
ᏕᎩᎭ	dé:gi:ha	All of us have solid things
ᏗᏍᏓᏓᎪᏩᏔ	disdada:gò:wahta	Let you both see each other
ᎩᎾᏓᎪᎲᎢ	ginada:go:hv̌:ɂi	You (1) and I saw ourselves a while ago
ᏕᏥᎭ	dé:ji:ha	You all have solid things
ᏫᏦᏣᏓᎪᏩᏔ	wijò:jada:gò:wahta	Let them and me see each other
ᎨᏃᎵᎦ	ge:no:lì:ga	You (1) and I recognize them (animate)
ᏕᏍᏓᏓᎪᎲᎢ	de:sdada:go:hv̌:ɂi	You both saw each other a while ago
ᏙᎩᎭ	dò:gi:ha	They and I have solid things
ᎢᏤᎦ	ì:jé:ga	You all are going
ᏫᏦᏍᏓᏓᎪᏩᏔ	wijò:sdada:gò:wahta	Let him and me see each other
ᎨᏙᎵᎦ	ge:do:lì:ga	All of us recognize them (animate)
ᏕᎩᎾᏓᎪᎲᎢ	de:ginada:go:hv̌:ɂi	You (1) and I saw each other a while ago
ᏚᏂᎭ	dù:ni:ha	They have solid things
ᏗᏣᏓᎪᏗ	dì:jada:kóhdi	For you all to have yourselves
ᎨᏦᎵᎦ	ge:jo:lì:ga	You all recognize them (animate)
ᏙᎩᎾᏓᎪᎲᎢ	dò:ginada:go:hv̌:ɂi	He and I saw each other a while ago
ᎩᏂᎭ	gini:ha	You (1) and I have something solid
ᎣᏍᏓᏓᎪᏩᏔ	ò:sdada:gò:wahtā	He and I recently saw ourselves
ᏕᏍᏗᎭ	de:sdi:ha	You both have solid things
ᎣᎩᏂᎭ	ò:gini:ha	He and I have something solid
ᏗᎦᏓᎪᏗ	digada:kóhdi	For all of us to have each other
ᏕᎩᏂᎭ	de:gini:ha	You (1) and I have solid things
ᏗᏣᏓᎪᏗ	dijada:kóhdi	For you all to have each other
ᏙᎩᏂᎭ	dò:gini:ha	He and I have solid things
ᏕᎪᎵᎦ	de:go:lì:ga	I understand things
ᎡᏍᏙᎵᎦ	è:sdo:lì:ga	You both recognize him; You both are being recognized
ᎨᏍᏙᎵᎦ	ge:sdo:lì:ga	You both recognize them (animate); They recognize you both
ᎮᎾ	hè:na	Let you (1) go
ᎤᏥ	u:ji	His mother
ᎤᎰᎢ	ù:hó:ɂi	He usually has something solid
ᎡᎾ	è:nā	He recently went
ᏦᎵᎦ	johlga	He recognizes you (1)
ᎤᏓᎧᎭ	ù:da:káha	He has himself
ᏗᎾᏓᏙᎵᎩ	dinada:dohlgi	Let you (1) and me be acquainted
ᏓᏍᏗᎦ	dasdǐ:gā	He recently ate rod shaped things
ᎠᎪᎵᎦ	à:go:lì:gā	He was recently recognized
ᏓᏂᏟᏌ	dà:nì:hlǐ:sā	They recently gathered things
ᏦᎦᏓᎪᏩᏛᏗ	jò:gada:gowhtv́hdi	For them and me to see each other
ᏫᏗᎦᏚᎩ	widigaɂdǔ:gi	Let me drink alcoholic drinks
ᏍᏕᎾ	sdè:na	Let you both go
ᏚᎰᎢ	du:hó:ɂi	He usually has solid things
ᎨᎾ	gè:nā	I recently went
ᎨᏦᎵᎦ	ge:johlga	They recognize you (1)
ᏣᏓᎧᎭ	jada:káha	You (1) have yourself
ᏗᏓᏓᏙᎵᎩ	didada:dohlgi	Let all of us be acquainted
ᏍᏆᏚᎳ	sgwadǔ:la	Let you (1) want me
ᎡᎪᎵᎦ	è:go:lì:gā	All of us were recently recognized
ᏕᏂᏟᏌ	dé:nì:hlǐ:sā	You (1) and I recently gathered things
ᏧᎾᏓᎪᏩᏛᏗ	jù:nada:gowhtv́hdi	For them to see each other
ᎢᏁᎾ	ì:nè:na	Let you (1) and me go
ᎠᏁᎾ	à:nè:nā	They recently went
ᎢᎬᏌ	ì:gv̌:sa	Ourselves, you all and I
ᎠᏆᏓᎧᎭ	à:gwada:káha	I have myself
ᏓᎾᏓᏙᎵᎦ	dà:nada:dohlga	They are acquainted
ᏫᏦᏣᏓᏙᎵᎩ	wijò:jada:dohlgi	Let them and me be acquainted
ᎡᏃᎵᎦ	è:no:lì:gā	You (1) and I recently recognized him
ᏕᏗᏟᏌ	dé:dì:hlǐ:sā	All of us recently gathered things
ᏦᎦᏤᎵᎢ	jò:gaje:li̋:ɂi	Our things, they and I
ᏗᏣᏚᎳ	dijadǔ:la	Let you (1) want them (inanimate); Let you all want them (inanimate)
ᏦᎩᎾᏓᎪᏩᏛᏗ	jò:ginada:gowhtv́hdi	For him and me to see each other
ᎢᏕᎾ	ì:dè:na	Let all of us go
ᎣᏤᎾ	ò:jè:nā	They and I recently went
ᎣᎬᏌ	ò:gv̌:sa	Ourselves, they and I
ᏕᎾᏓᏙᎵᎦ	dé:nada:dohlga	You (1) and I are acquainted
ᏫᏦᏍᏓᏓᏙᎵᎩ	wijò:sdada:dohlgi	Let him and me be acquainted
ᏘᏟᏌ	tìhlǐ:sa	Let you (1) gather things
ᎡᏙᎵᎦ	è:do:lì:gā	All of us recently recognized him
ᏙᏥᏟᏌ	dò:jì:hlǐ:sā	They and I recently gathered things
ᏧᎾᏤᎵᎢ	jù:naje:li̋:ɂi	Their things
ᎩᎾᏓᏚᎳ	ginadadǔ:la	Let you (1) and me want ourselves
ᎢᏤᎾ	ì:jè:na	Let you all go
ᎤᏅᏌ	ù:nv̌:sa	Themselves
ᏕᎬᏯ	dé:gù:wâ:ya	All of us have rod shaped things
ᎣᏍᏕᎾ	ò:sdè:nā	He and I recently went
ᏕᏓᏓᏙᎵᎦ	dé:dada:dohlga	All of us are acquainted
ᎡᏦᎵᏍᏗ	è:jo:hlísdi	For you (1) to be recognized
ᏗᏍᏗᏟᏌ	disdì:hlǐ:sa	Let you both gather things
ᎡᏦᎵᎦ	è:jo:lì:gā	You all recently recognized him; You all were recently recognized
ᏙᏍᏗᏟᏌ	dò:sdì:hlǐ:sā	He and I recently gathered things
ᏗᎦᏤᎵᎢ	digaje:li̋:ɂi	Our things, you all and I
ᏗᎦᏓᏚᎳ	digadadǔ:la	Let all of us want each other
ᏕᏨᏯ	dé:jù:wâ:ya	You all have rod shaped things
ᎩᏅᏌ	ginv̌:sa	Ourselves, you (1) and I
ᏕᎯᏰᎠ	de:hihyé:ɂa	You (1) are eating flexible things
ᏙᏣᏓᏙᎵᎦ	dò:jada:dohlga	They and I are acquainted
ᎬᏉᎵᏍᏗ	gv:gwo:hlísdi	For them to recognize me
ᏗᏗᏟᏌ	didì:hlǐ:sa	Let all of us gather things
ᏗᏆᏤᎵᎢ	dìgwaje:li̋:ɂi	My things
ᏫᏦᏣᏚᎩ	wijò:jatǔ:gi	Let them and me drink alcoholic drinks
ᏗᏍᏓᏓᏚᎳ	disdadadǔ:la	Let you both want each other
ᎥᏆᏚᎳ	v̀:gwadǔ:lā	I was recently wanted
ᎣᎩᏅᏌ	ò:ginv̌:sa	Ourselves, he and I
ᏙᏍᏓᏓᏙᎵᎦ	dò:sdada:dohlga	He and I are acquainted
ᏗᏂᏟᏌ	dínì:hlǐ:sa	Let you (1) and me gather things
ᏗᎩᎾᏓᏙᎵᏍᏗ	diginada:do:hlísdi	For you (1) and me to be acquainted
ᎨᏃᎵᎦ	ge:no:lì:gā	You (1) and I recently recognized them (animate)
ᏦᎩᎾᏤᎵᎢ	jò:ginaje:li̋:ɂi	Our things, he and I
ᏫᏗᎾᏚᎩ	widinatǔ:gi	Let them drink alcoholic drinks
ꮷꮹᏘᏗ	ju:wà:tdi	For him to bake things
ᏗᎩᎾᏤᎵᎢ	diginaje:li̋:ɂi	Our things, you (1) and I
ᏫᏦᏍᏓᏚᎩ	wijò:sdatǔ:gi	Let him and me drink alcoholic drinks
ᏕᏍᏛᏯ	de:sdù:wâ:ya	You both have rod shaped things
ᏍᏓᏓᎪᏩᏔ	sdada:gò:wahta	Let you both see yourselves
ᎨᎩᎪᎲᎢ	ge:gi:go:hv̌:ɂi	They saw all of us a while ago
ᏫᏗᎪᏩᏔ	widigò:wahta	Let him see them
ᎪᎩᎪᎲᎢ	go:gi:go:hv̌:ɂi	They saw them and me a while ago
ᎢᎦᏓᎪᎲᎢ	ì:gada:go:hv̌:ɂi	All of us saw ourselves a while ago
ᎢᏣᏓᎪᎲᎢ	ì:jada:go:hv̌:ɂi	You all saw yourselves a while ago
ᏗᏣᏓᎪᏩᏔ	dijada:gò:wahta	Let you all see each other
ᎣᎦᏓᎪᎲᎢ	ò:gada:go:hv̌:ɂi	They and I saw ourselves a while ago
ᏓᎩᎭ	dà:giha	I have solid things
ᎤᎾᏓᎪᎲᎢ	ù:nada:go:hv̌:ɂi	They saw themselves a while ago
ᏕᏣᎭ	de:jaha	You (1) have solid things
ᎨᎩᏂᎪᎲᎢ	ge:gini:go:hv̌:ɂi	They saw you (1) and me a while ago
ᎪᎩᏂᎪᎲᎢ	go:gini:go:hv̌:ɂi	They saw him and me a while ago
ᎨᏍᏙᎵᎦ	ge:sdo:lì:gā	You both recently recognized them (animate); They recently recognized you both
ᎣᎩᎾᏓᎪᎲᎢ	ò:ginada:go:hv̌:ɂi	He and I saw ourselves a while ago
ᎡᎩᏃᎵᎦ	è:gino:lì:gā	You (1) and I were recently recognized
ᏨᏌ	jv̋:sa	You (1) alone
ᎬᏥ	gv:ji	I, your mother
ᎤᎲᎢ	ù:hv̌:ɂi	He had something solid a while ago
ᎦᏓ	gadā	I recently said
ᏓᏋᏲᎢ	dà:gwù:wǎ:yóɂi	I usually have rod shaped things
ᏦᎩᏰᏍᏗ	jò:gi:hyè:sdi	For them and me to eat flexible things
ᏫᏗᏍᏗᎦ	widisdǐ:ga	Let him eat rod shaped things
ᏦᎵᎦ	johlgā	He recently recognized you (1)
ᎨᎪᎵᎪᎢ	ge:go:li:gó:ɂi	They are often recognized
ᏦᎦᏓᏚᎸᏗ	jò:gadaduhldi	For them and me to want each other
ᏕᎦᏓᏙᎵᏨᎢ	dé:gada:dohljv̌:ɂi	All of us were acquainted a while ago
ᏕᎦᏚᎦ	de:gaɂdǔ:gā	I recently drank alcoholic drinks
ᏗᏓᏓᎦᏙᏍᏓ	didadaktǒ:sda	Let all of us look at each other
ᎠᏋᏌ	à:gwv̋:sa	I alone
ᏚᎲᎢ	du:hv̌:ɂi	He had solid things a while ago
ᏕᏨᏲᎢ	de:jù:wǎ:yóɂi	You (1) usually have rod shaped things
ᏧᏂᏰᏍᏗ	jù:ni:hyè:sdi	For them to eat flexible things
ᏓᎾᏚᎦ	dà:natǔ:gā	They recently drank alcoholic drinks
ᏧᎾᏓᏚᎸᏗ	jù:nadaduhldi	For them to want each other
ᏙᎦᏓᏙᎵᏨᎢ	dò:gada:dohljv̌:ɂi	They and I were acquainted a while ago
ᏫᏦᏣᏓᎦᏙᏍᏓ	wijò:jadaktǒ:sda	Let them and me look at each other
ᏕᎩᎰᎢ	dé:gi:hó:ɂi	All of us usually have solid things
ᏦᎩᏂᏰᏍᏗ	jò:gini:hyè:sdi	For him and me to eat flexible things
ᏕᎾᏚᎦ	dé:natǔ:gā	You (1) and I recently drank alcoholic drinks
ᏚᎾᏓᏙᎵᏨᎢ	dù:nada:dohljv̌:ɂi	They were acquainted a while ago
ᏦᎩᎾᏓᏚᎸᏗ	jò:ginadaduhldi	For him and me to want each other
ᏫᏦᏍᏓᏓᎦᏙᏍᏓ	wijò:sdadaktǒ:sda	Let him and me look at each other
ᏙᎩᎰᎢ	dò:gi:hó:ɂi	They and I usually have solid things
ᏗᎩᎾᏓᎪᏩᏛᏗ	diginada:gowhtv́hdi	For you (1) and me to see each other
ᏕᏓᏚᎦ	dé:datǔ:gā	All of us recently drank alcoholic drinks
ᏕᎩᎾᏓᏙᎵᏨᎢ	de:ginada:dohljv̌:ɂi	You (1) and I were acquainted a while ago
ᏚᏂᎰᎢ	dù:ni:hó:ɂi	They usually have solid things
ᏙᎵᎩ	tohlgi	Let you (1) understand things
ᏙᏣᏚᎦ	dò:jatǔ:gā	They and I recently drank alcoholic drinks
ᏙᎩᎾᏓᏙᎵᏨᎢ	dò:ginada:dohljv̌:ɂi	He and I were acquainted a while ago
ᏕᎩᏂᎰᎢ	de:gini:hó:ɂi	You (1) and I usually have solid things
ᏗᏙᎵᎩ	didohlgi	Let all of us understand things
ᎨᏃᎵᎩ	ge:no:lì:gi	Let you (1) and me recognize them (animate)
ᏕᎯᏟᏌ	de:hìhlǐ:sā	You (1) recently gathered things
ᏙᏍᏓᏚᎦ	dò:sdatǔ:gā	He and I recently drank alcoholic drinks
ᏙᎩᏂᎰᎢ	dò:gini:hó:ɂi	He and I usually have solid things
ᏍᏕᎾ	sdè:nā	You both recently went
ᏕᏥᏰᎠ	dé:ji:hyé:ɂa	You all are eating flexible things
ᏗᏃᎵᎩ	dínohlgi	Let you (1) and me understand things
ᎨᏙᎵᎩ	ge:do:lì:gi	Let all of us recognize them (animate)
ᏗᎦᏚᎳ	digadǔ:la	Let all of us want them (inanimate)
ᏬᏤᎾ	wò:jè:na	Let them and me go
ᏕᎦᏰᎠ	de:gahyé:ɂa	He is eating flexible things
ᎡᏦᎵᎦ	è:johlga	You (1) are being recognized
ᎨᏦᎵᎩ	ge:jo:lì:gi	Let you all recognize them (animate)
ᎥᏉᎵᏍᏗ	v̀:gwo:hlísdi	For me to be recognized
ᏗᏥᏟᏌ	dijì:hlǐ:sa	Let you all gather things
ᎢᎦᏓᏚᎳ	ì:gadadǔ:la	Let all of us want ourselves
ᏬᏍᏕᎾ	wò:sdè:na	Let him and me go
ᏕᏍᏗᏰᎠ	de:sdi:hyé:ɂa	You both are eating flexible things
ᎬᏉᎵᎦ	gv:gwohlga	They recognize me
ᎯᏲᎵᎩ	hi:yo:lì:gi	Let you (1) recognize him
ᏗᏉᎵᏍᏗ	dìgwo:hlísdi	For me to understand things
ᏫᏗᏥᏟᏌ	widijìhlǐ:sa	Let me gather things
ᏗᏍᏓᏤᎵᎢ	disdaje:li̋:ɂi	You both, your things
ᏗᎩᎾᏚᎳ	diginadǔ:la	Let you (1) and me want them (inanimate)
ᎠᏓᏙᎵᎦ	à:da:dohlga	He recognizes himself
ᏗᎦᏓᏙᎵᏍᏗ	digada:do:hlísdi	For all of us to be acquainted
ᏗᏣᏓᏚᎳ	dijadadǔ:la	Let you all want each other
ᎭᏓᏙᎵᎦ	hada:dohlga	You (1) recognize yourself
ᎡᏍᏙᎵᎩ	è:sdo:lì:gi	Let you both recognize him; Let you both be recognized
ᏗᏍᏓᏓᏙᎵᏍᏗ	disdada:do:hlísdi	For you both to be acquainted
ᎢᎬᏯ	ì:gù:wâ:ya	All of us have something rod shaped
ᎠᎾᏓᏙᎵᎦ	à:nada:dohlga	They recognize themselves
ᎨᏍᏙᎵᎩ	ge:sdo:lì:gi	Let you both recognize them (animate)
ᏍᏆᏚᎳ	sgwadǔ:lā	You (1) recently wanted me
ᎣᎬᏯ	ò:gù:wâ:ya	They and I have something rod shaped
ᎢᎾᏓᏙᎵᎦ	ì:nada:dohlga	You (1) and I recognize ourselves
ᎡᎩᏃᎵᎩ	è:gino:lì:gi	Let you (1) and me be recognized
ᎨᏣᏚᎳ	gé:jadǔ:lā	They recently wanted you all
ᎢᏓᏓᏙᎵᎦ	ì:dada:dohlga	All of us recognize ourselves
ᎪᏣᏚᎳ	go:jadǔ:lā	They and I recently wanted them (animate)
ᎣᏣᏓᏙᎵᎦ	ò:jada:dohlga	They and I recognize ourselves
ᎪᏍᏓᏚᎳ	go:sdadǔ:lā	He and I recently wanted them (animate)
ᎢᏣᏓᎪᏩᏔ	ì:jada:gò:wahta	Let you all see yourselves
ᎣᏍᏓᏓᏙᎵᎦ	ò:sdada:dohlga	He and I recognize ourselves
ᏫᏦᏥᎪᏩᏔ	wijò:ji:gò:wahta	Let them and me see them (inanimate)
ᎨᎩᎪᏩᏔ	ge:gi:gò:wahtā	They recently saw all of us
ᏫᏗᏂᎪᏩᏔ	widini:gò:wahta	Let them see them
ᎪᎩᎪᏩᏔ	go:gi:gò:wahtā	They recently saw them and me
ᏫᏦᏍᏗᎪᏩᏔ	wijò:sdi:gò:wahta	Let him and me see them (inanimate)
ᎬᎪᎲᎢ	gv:go:hv̌:ɂi	I saw you (1) a while ago
ᏫᏗᎾᏓᎪᏩᏔ	widinada:gò:wahta	Let them see each other
ᏥᎪᎲᎢ	ji:go:hv̌:ɂi	I saw him a while ago
ᎨᎩᏂᎪᏩᏔ	ge:gini:gò:wahtā	They recently saw you (1) and me
ᎪᎩᏂᎪᏩᏔ	go:gini:gò:wahtā	They recently saw him and me
ᎢᏨᎪᎲᎢ	ì:jv:go:hv̌:ɂi	I, we two, or we all saw you all a while ago; We all saw you (1), two a while ago
ᎤᏓᎪᎲᎢ	ù:da:go:hv̌:ɂi	He saw himself a while ago
ᏣᏓᎪᎲᎢ	jada:go:hv̌:ɂi	You (1) saw yourself a while ago
ᎠᏆᏓᎪᎲᎢ	à:gwada:go:hv̌:ɂi	I saw myself a while ago
ᎦᏓᏙᎵᎦ	gada:do:lì:gā	I recently recognized myself
ᎤᏁᏗ	ù:nehdi	For him to have a liquid
ᎯᏥ	hi:ji	You one, his mother
ᎭᏓ	hada	Let you (1) say
ᏫᏗᏯᎦ	widihyaga	Let him eat flexible things
ᎨᎪᎵᏍᏗ	ge:go:lí:sdi	For them to be recognized
ᏓᎾᏓᏙᎵᎪᎢ	dà:nada:dohlgó:ɂi	They usually are acquainted
ᏕᎦᏓᏚᎵᎭ	dé:gadadu:líha	All of us are wanting each other
ᎢᎾᏓ	ì:nada	Let you (1) and me say
ᎠᏓ	adā	He recently said
ᏫᏦᏥᏍᏗᎦ	wijò:ji:sdǐ:ga	Let them and me eat rod shaped things
ᏕᎾᏓᏙᎵᎪᎢ	dé:nada:dohlgó:ɂi	You (1) and I usually are acquainted
ᏕᎪᎵᎪᎢ	de:go:li:gó:ɂi	I usually understand things
ᏙᎦᏓᏚᎵᎭ	dò:gadadu:líha	They and I are wanting each other
ᎢᎬᏌ	ì:gv̋:sa	All of us alone
ᎢᏓᏓ	ì:dada	Let all of us say
ᏕᎩᎲᎢ	dé:gi:hv̌:ɂi	All of us had solid things a while ago
ᎠᎾᏓ	à:nadā	They recently said
ᏫᏗᏂᏍᏗᎦ	widini:sdǐ:ga	Let them eat rod shaped things
ᏕᏓᏓᏙᎵᎪᎢ	dé:dada:dohlgó:ɂi	All of us usually are acquainted
ᎦᏓᏙᎵᎪᎢ	gada:do:li:gó:ɂi	I usually recognize myself
ᏚᎾᏓᏚᎵᎭ	dù:nadadu:líha	They are wanting each other
ᎣᎬᏌ	ò:gv̋:sa	They and I alone
ᏙᎩᎲᎢ	dò:gi:hv̌:ɂi	They and I had solid things a while ago
ᏣᎧᎭ	jakáha	He has you (1)
ᎣᏣᏓ	ò:jadā	They and I recently said
ᏗᎩᏰᏍᏗ	digi:hyè:sdi	For all of us to eat flexible things
ᏫᏦᏍᏗᏍᏗᎦ	wijò:sdi:sdǐ:ga	Let him and me eat rod shaped things
ᏙᏣᏓᏙᎵᎪᎢ	dò:jada:dohlgó:ɂi	They and I usually are acquainted
ᏗᎩᎾᏓᏚᎸᏗ	diginadaduhldi	For you (1) and me to want each other
ᏕᎩᎾᏓᏚᎵᎭ	de:ginadadu:líha	You (1) and I are wanting each other
ᏗᎾᏓᎦᏙᏍᏓ	dinadaktǒ:sda	Let you (1) and me look at each other
ᎤᏅᏌ	ù:nv̋:sa	They alone
ᏚᏂᎲᎢ	dù:ni:hv̌:ɂi	They had solid things a while ago
ᎣᏍᏓᏓ	ò:sdadā	He and I recently said
ᏙᎦᏓᎧᎭ	dò:gada:káha	They and I have each other
ᏙᏍᏓᏓᏙᎵᎪᎢ	dò:sdada:dohlgó:ɂi	He and I usually are acquainted
ᏗᎦᏓᎪᏩᏛᏗ	digada:gowhtv́hdi	For all of us to see each other
ᏙᎩᎾᏓᏚᎵᎭ	dò:ginadadu:líha	He and I are wanting each other
ᎩᏅᏌ	ginv̋:sa	You (1) and I alone
ᏕᎩᏂᎲᎢ	de:gini:hv̌:ɂi	You (1) and I had solid things a while ago
ᏚᎾᏓᎧᎭ	dù:nada:káha	They have each other
ᏗᎩᏂᏰᏍᏗ	digini:hyè:sdi	For you (1) and me to eat flexible things
ᎣᎩᏅᏌ	ò:ginv̋:sa	He and I alone
ᏙᎩᏂᎲᎢ	dò:gini:hv̌:ɂi	He and I had solid things a while ago
ᏙᎩᎾᏓᎧᎭ	dò:ginada:káha	He and I have each other
ᏕᎦᏚᎦ	de:gatǔ:gā	He recently drank alcoholic drinks
ᏕᏥᎰᎢ	dé:ji:hó:ɂi	You all usually have solid things
ᏗᏦᎵᎩ	dijohlgi	Let you all understand things
ᏕᏍᏗᎰᎢ	de:sdi:hó:ɂi	You both usually have solid things
ᏗᏍᏓᏓᏙᎵᎩ	disdada:dohlgi	Let you both be acquainted
ᏗᏍᏓᏚᎩ	disdatǔ:gi	Let you both drink alcoholic drinks
ᎨᎾᏚᎳ	ge:nadǔ:la	Let you (1) and me want them (animate)
ᏍᏉᎵᏍᏗ	sgwo:hlísdi	For you (1) to recognize me
ᎠᎾᏓᏙᎵᎦ	à:nada:dohlgā	They recently recognized themselves
ᎨᏓᏚᎳ	ge:dadǔ:la	Let all of us want them (animate)
ᎨᎪᎵᏍᏗ	ge:go:hlísdi	For them to recognize all of us
ᎨᏣᏚᎳ	ge:jadǔ:la	Let you all want them (animate)
ᎪᎪᎵᏍᏗ	go:go:hlísdi	For them to recognize them and me
ᎨᏍᏓᏚᎳ	ge:sdadǔ:la	Let you both want them (animate)
ᏦᎪᎵᏍᏗ	jò:go:hlísdi	For them and me to understand things
ᏧᏬᎵᏍᏗ	ju:wo:hlísdi	For him to understand things; For him to recognize them (animate)
ᏍᏓᏓᏚᎳ	sdadadǔ:la	Let you both want yourselves
ᏍᏗᎭ	sdi:ha	You both have something solid
ᏚᏮᏯ	du:wù:wâ:ya	He has rod shaped things
ᎥᏉᎵᎦ	v̀:gwohlga	I am being recognized
ᏧᏃᎵᏍᏗ	jù:no:hlísdi	For them to understand things; For them to recognize them (animate)
ᏣᎭ	jaha	You (1) have something solid
ᏕᎰᎵᎦ	de:hohlga	You (1) understand things
ᏗᏦᎵᏍᏗ	dijo:hlísdi	For you (1) to understand things; For you all to understand things
ᎢᏥᎭ	ì:ji:ha	You all have something solid
ᎨᎩᏃᎵᏍᏗ	ge:gino:hlísdi	For them to recognize you (1) and me
ᎠᎩᎭ	à:giha	I have something solid
ᎪᎩᏃᎵᏍᏗ	go:gino:hlísdi	For them to recognize him and me
ᏤᎩᏂᎪᏗ	jè:gini:kóhdi	For someone to have you (1) and me
ᏘᎪᏩᏔ	tigò:wahta	Let you (1) see them (inanimate)
ᏦᎩᏃᎵᏍᏗ	jò:gino:hlísdi	For him and me to understand things
ᏗᏗᎪᏩᏔ	didi:gò:wahta	Let all of us see them (inanimate)
ᎩᎾᏓᏙᎵᏍᏗ	ginada:do:hlísdi	For you (1) and me to recognize ourselves
ᎠᎦᏚᎳ	à:gadǔ:lā	He was recently wanted
ᏗᏂᎪᏩᏔ	díni:gò:wahta	Let you (1) and me see them (inanimate)
ᏗᏣᏓᏙᎵᏍᏗ	dijada:do:hlísdi	For you all to be acquainted
ᏫᏗᏥᎪᏩᏔ	widijigò:wahta	Let me see them (inanimate)
ᏓᏂᎪᏩᏔ	dà:ni:gò:wahtā	They recently saw them
ᏕᏂᎪᏩᏔ	dé:ni:gò:wahtā	You (1) and I recently saw them (inanimate)
ᎪᎵᎦ	go:lì:ga	I understand it
ᎨᏥᎪᎲᎢ	gé:ji:go:hv̌:ɂi	They saw you all a while ago
ᏕᏗᎪᏩᏔ	dé:di:gò:wahtā	All of us recently saw them (inanimate)
ᎪᏥᎪᎲᎢ	go:ji:go:hv̌:ɂi	They and I saw them (animate) a while ago
ᏙᏥᎪᏩᏔ	dò:ji:gò:wahtā	They and I recently saw them (inanimate)
ᏙᏍᏗᎪᏩᏔ	dò:sdi:gò:wahtā	He and I recently saw them (inanimate)
ᎪᏍᏗᎪᎲᎢ	go:sdi:go:hv̌:ɂi	He and I saw them (animate) a while ago
ᏥᏥ	ji:ji	I, his mother
ᏕᏥᏰᎠ	de:jiyé:ɂa	I am eating flexible things
ᏫᏓᎭᏗᏔ	wida:dǐ:ta	Let him drink drinks
ᏓᎾᏓᎦᏙᏍᏗ	dà:nadà:ktǒ:sdi	They are looking at each other
ᎦᏓᎦᏙᏍᏗ	gadagà:tǒ:sdi	I am looking at myself
ᏦᎦᏓᎦᏙᏍᏙᏗ	jò:gadaktǒ:sdóhdi	For them and me to look at each other
ᏕᎦᏓᏚᎸᎲᎢ	dé:gadadu:lv:hv̌:ɂi	All of us wanted each other a while ago
ᏫᏦᏥᏯᎦ	wijò:ji:hyaga	Let them and me eat flexible things
ᏓᏂᏍᏗᎦ	dà:ni:sdǐ:gā	They recently ate rod shaped things
ᏧᏂᏟᏐᏗ	jù:nì:hlǐ:sóhdi	For them to gather things
ᏕᎾᏓᎦᏙᏍᏗ	dé:nadà:ktǒ:sdi	You (1) and I are looking at each other
ᏧᎾᏓᎦᏙᏍᏙᏗ	jù:nadaktǒ:sdóhdi	For them to look at each other
ᏙᎦᏓᏚᎸᎲᎢ	dò:gadadu:lv:hv̌:ɂi	They and I wanted each other a while ago
ᏕᏂᏍᏗᎦ	dé:ni:sdǐ:gā	You (1) and I recently ate rod shaped things
ᏗᎩᏟᏐᏗ	dìgìhlǐ:sóhdi	For me to gather things
ᏕᏓᏓᎦᏙᏍᏗ	dé:dadà:ktǒ:sdi	All of us are looking at each other
ᏚᎾᏓᏚᎸᎲᎢ	dù:nadadu:lv:hv̌:ɂi	They wanted each other a while ago
ᏦᎩᎾᏓᎦᏙᏍᏙᏗ	jò:ginadaktǒ:sdóhdi	For him and me to look at each other
ᏕᏗᏍᏗᎦ	dé:di:sdǐ:gā	All of us recently ate rod shaped things
ᏦᎩᏂᏟᏐᏗ	jò:ginì:hlǐ:sóhdi	For him and me to gather things
ᏙᏣᏓᎦᏙᏍᏗ	dò:jadà:ktǒ:sdi	They and I are looking at each other
ᏕᎩᎾᏓᏚᎸᎲᎢ	de:ginadadu:lv:hv̌:ɂi	You (1) and I wanted each other a while ago
ᏘᏍᏗᎦ	tisdǐ:ga	Let you (1) eat rod shaped things
ᏙᏥᏍᏗᎦ	dò:ji:sdǐ:gā	They and I recently ate rod shaped things
ᏗᎦᏓᏚᎸᏗ	digadaduhldi	For all of us to want each other
ᏙᏍᏓᏓᎦᏙᏍᏗ	dò:sdadà:ktǒ:sdi	He and I are looking at each other
ᏙᎩᎾᏓᏚᎸᎲᎢ	dò:ginadadu:lv:hv̌:ɂi	He and I wanted each other a while ago
ᏙᎬᏲᎢ	dò:gù:wǎ:yóɂi	They and I usually have rod shaped things
ᏗᏗᏍᏗᎦ	didi:sdǐ:ga	Let all of us eat rod shaped things
ᏙᏍᏗᏍᏗᎦ	dò:sdi:sdǐ:gā	He and I recently ate rod shaped things
ᏧᎪᏩᏛᏗ	ju:gowhtv́hdi	For him to see them
ᏥᏲᎵᎪᎢ	ji:yo:li:gó:ɂi	I usually recognize him
ᏚᏅᏲᎢ	dù:nù:wǎ:yóɂi	They usually have rod shaped things
ᏗᏣᏰᏍᏗ	dijahyè:sdi	For you (1) to eat flexible things
ᏗᏂᏍᏗᎦ	díni:sdǐ:ga	Let you (1) and me eat rod shaped things
ᏕᎦᏟᏌ	de:gàhlǐ:sā	He recently gathered things
ᏗᏍᏓᏓᎪᏩᏛᏗ	disdada:gowhtv́hdi	For you both to see each other
ᏍᏛᏌ	sdv̌:sa	Your two selves
ᏕᏥᎲᎢ	dé:ji:hv̌:ɂi	You all had solid things a while ago
ᏗᏥᏰᏍᏗ	diji:hyè:sdi	For you all to eat flexible things
ᏕᎩᏅᏲᎢ	de:ginù:wǎ:yóɂi	You (1) and I usually have rod shaped things
ᏫᏗᏥᏍᏗᎦ	widijisdǐ:ga	Let me eat rod shaped things
ᎦᏥᏲᎵᎪᎢ	gaji:yo:li:gó:ɂi	I usually recognize them (animate)
ᎢᏨᏌ	ì:jv̌:sa	Your all selves
ᏕᏍᏗᎲᎢ	de:sdi:hv̌:ɂi	You both had solid things a while ago
ᏙᎩᏅᏲᎢ	dò:ginù:wǎ:yóɂi	He and I usually have rod shaped things
ᏕᎩᎾᏓᎧᎭ	de:ginada:káha	You (1) and I have each other
ᎢᎩᎰᎢ	ì:gi:hó:ɂi	All of us usually have something solid
ᎣᎩᎰᎢ	ò:gi:hó:ɂi	They and I usually have something solid
ᎤᏂᎰᎢ	ù:ni:hó:ɂi	They usually have something solid
ᎩᏂᎰᎢ	gini:hó:ɂi	You (1) and I usually have something solid
ᏓᎩᎰᎢ	dà:gihó:ɂi	I usually have solid things
ᏕᏣᎰᎢ	de:jahó:ɂi	You (1) usually have solid things
ᎣᎩᏂᎰᎢ	ò:gini:hó:ɂi	He and I usually have something solid
ᏗᏣᏓᏙᎵᎩ	dijada:dohlgi	Let you all be acquainted
ᏍᎩᏃᎵᎩ	sgino:lì:gi	Let you (1) or both recognize us both
ᏕᎰᎵᎦ	de:hohlgā	You (1) recently understood things
ᏫᏗᎾᏓᏙᎵᎩ	widinada:dohlgi	Let them be acquainted
ᎡᎦᏚᎳ	è:gadǔ:la	Let all of us be wanted
ᎡᎾᏚᎳ	è:nadǔ:la	Let you (1) and me want him
ᎡᏓᏚᎳ	è:dadǔ:la	Let all of us want him
ᎡᏣᏚᎳ	è:jadǔ:la	Let you all want him; Let you (1) be wanted; Let you all be wanted
ᏗᎪᎵᏍᏗ	digo:hlísdi	For all of us to understand things
ᏗᎩᏃᎵᏍᏗ	digino:hlísdi	For you (1) and me to understand things
ᎡᏍᏓᏚᎳ	è:sdadǔ:la	Let you both want him; Let you both be wanted
ᎨᎾᏚᎳ	ge:nadǔ:lā	You (1) and I recently wanted them (animate)
ᎦᎯᎪᏩᏔ	gahi:gò:wahta	Let you (1) see them (animate)
ᎡᎩᎾᏚᎳ	è:ginadǔ:la	Let you (1) and me be wanted
ᎨᏓᏚᎳ	ge:dadǔ:lā	All of us recently wanted them (animate)
ᎨᏣᏚᎳ	ge:jadǔ:lā	You all recently wanted them (animate); They recently wanted you (1)
ᎨᏍᏓᏚᎳ	ge:sdadǔ:lā	You both recently wanted them (animate); They recently wanted you both
ᏚᎪᎲᎢ	du:go:hv̌:ɂi	He saw them a while ago
ᎨᏥᎪᏩᏔ	gé:ji:gò:wahtā	They recently saw you all
ᎪᏥᎪᏩᏔ	go:ji:gò:wahtā	They and I recently saw them (animate)
ᎬᎩᎪᎲᎢ	gv:gigo:hv̌:ɂi	They saw me a while ago
ᎪᏍᏗᎪᏩᏔ	go:sdi:gò:wahtā	He and I recently saw them (animate)
ᎠᏴ	ayv	I, Me; We, Us
ᏚᎮᏍᏗ	du:hé:sdi	He will be having solid things
ᎠᏗᎭ	adiha	He is saying
ᏫᏗᏥᏯᎦ	widijiyaga	Let me eat flexible things
ᎦᏗᎠ	gadí:ɂa	I am saying
ᎤᏲᏏᏌ	ù:yò:sǐ:sā	He was recently hungry
ᎤᏓᎧᎰᎢ	ù:da:kahó:ɂi	He usually has himself
ᏫᏦᏥᏚᎲᎦ	wijò:jì:du:hv̀:ga	Let them and me bake things
ᏓᎾᏓᎪᏩᏘᎭ	dà:nada:gowhtíha	They are seeing each other
ᏧᏍᏗᎩᏍᏗ	ju:sdǐ:gî:sdi	For him to eat rod shaped things
ᏦᎦᏚᎩᏍᏗ	jò:gatǔ:gî:sdi	For them and me to drink alcoholic drinks
ᎦᏓᎦᏙᏍᏓ	gadagà:tǒ:sdā	I recently looked at myself
ᎭᏗᎭ	hadiha	You (1) are saying
ᏣᏓᎧᎰᎢ	jada:kahó:ɂi	You (1) usually have yourself
ᏫᏗᏂᏚᎲᎦ	widinì:du:hv̀:ga	Let them bake things
ᏕᎾᏓᎪᏩᏘᎭ	dé:nada:gowhtíha	You (1) and I are seeing each other
ᏧᎾᏚᎩᏍᏗ	jù:natǔ:gî:sdi	For them to drink alcoholic drinks
ᎬᏲᎵᏍᏗ	gv:yo:lí:sdi	For me to recognize you (1)
ᏫᏦᏍᏗᏚᎲᎦ	wijò:sdì:du:hv̀:ga	Let him and me bake things
ᎠᏆᏓᎧᎰᎢ	à:gwada:kahó:ɂi	I usually have myself
ᏕᏓᏓᎪᏩᏘᎭ	dé:dada:gowhtíha	All of us are seeing each other
ᏥᏲᎵᏍᏗ	ji:yo:lí:sdi	For me to recognize him
ᏙᏣᏓᎪᏩᏘᎭ	dò:jada:gowhtíha	They and I are seeing each other
ᏗᏆᏚᎩᏍᏗ	dìgwatǔ:gî:sdi	For me to drink alcoholic drinks
ᏘᏯᎦ	tihyaga	Let you (1) eat flexible things
ᏙᏍᏗᏯᎦ	dò:sdi:hyagā	He and I recently ate flexible things
ᏍᏛᏲᎵᏍᏗ	sdv:yo:lí:sdi	For me to recognize you both; For we two to recognize you (1) or you both
ᏙᏍᏓᏓᎪᏩᏘᎭ	dò:sdada:gowhtíha	He and I are seeing each other
ᏗᎩᏟᏐᏗ	digì:hlǐ:sóhdi	For all of us to gather things
ᏫᏗᎾᏓᎦᏙᏍᏓ	widinadaktǒ:sda	Let them look at each other
ᏦᎩᎾᏚᎩᏍᏗ	jò:ginatǔ:gî:sdi	For him and me to drink alcoholic drinks
ᏗᎦᏓᎦᏙᏍᏙᏗ	digadaktǒ:sdóhdi	For all of us to look at each other
ᏙᎬᏴᎢ	dò:gù:wǎ:yv́:ɂi	They and I had rod shaped things a while ago
ᏗᏗᏯᎦ	didi:hyaga	Let all of us eat flexible things
ᎦᏥᏲᎵᏍᏗ	gaji:yo:lí:sdi	For me to recognize them (animate)
ᏗᏍᏓᏓᏚᎸᏗ	disdadaduhldi	For you both to want each other
ᏗᎩᏂᏟᏐᏗ	diginì:hlǐ:sóhdi	For you (1) and me to gather things
ᏗᏂᏯᎦ	díni:hyaga	Let you (1) and me eat flexible things
ᎠᏓᏙᎵᎪᎢ	à:da:dohlgó:ɂi	He usually recognizes himself
ᏗᏣᏓᎪᏩᏛᏗ	dijada:gowhtv́hdi	For you all to see each other
ᏗᏍᏗᏰᏍᏗ	disdi:hyè:sdi	For you both to eat flexible things
ᎭᏓᏙᎵᎪᎢ	hada:dohlgó:ɂi	You (1) usually recognize yourself
ᎢᎩᎲᎢ	ì:gi:hv̌:ɂi	All of us had something solid a while ago
ᎡᏣᎧᎭ	è:jakáha	Someone has you (1)
ᏫᏗᎦᏟᏌ	widigàhlǐ:sa	Let him gather things
ᎠᎾᏓᏙᎵᎪᎢ	à:nada:dohlgó:ɂi	They usually recognize themselves
ᎣᎩᎲᎢ	ò:gi:hv̌:ɂi	They and I had something solid a while ago
ᎢᎾᏓᏙᎵᎪᎢ	ì:nada:dohlgó:ɂi	You (1) and I usually recognize ourselves
ᎤᏂᎲᎢ	ù:ni:hv̌:ɂi	They had something solid a while ago
ᎢᏓᏓᏙᎵᎪᎢ	ì:dada:dohlgó:ɂi	All of us usually recognize ourselves
ᎩᏂᎲᎢ	gini:hv̌:ɂi	You (1) and I had something solid a while ago
ᏕᏥᏟᏌ	de:jìhlǐ:sā	I recently gathered things
ᎣᏣᏓᏙᎵᎪᎢ	ò:jada:dohlgó:ɂi	They and I usually recognize ourselves
ᏓᎩᎲᎢ	dà:gihv̌:ɂi	I had solid things a while ago
ᏕᏣᏓᏙᎵᎪᎢ	dé:jada:dohlgó:ɂi	You all usually are acquainted
ᏕᏣᎲᎢ	de:jahv̌:ɂi	You (1) had solid things a while ago
ᎣᏍᏓᏓᏙᎵᎪᎢ	ò:sdada:dohlgó:ɂi	He and I usually recognize ourselves
ᎣᎩᏂᎲᎢ	ò:gini:hv̌:ɂi	He and I had something solid a while ago
ᏕᏍᏓᏓᏙᎵᎪᎢ	de:sdada:dohlgó:ɂi	You both usually are acquainted
ᏍᎩᏃᎵᎩ	sgino:lì:gi	Let you both recognize me
ᏕᎪᎵᎦ	de:gohlga	He understands things; He recognizes them (animate)
ᏍᏓᏓᏙᎵᏍᏗ	sdada:do:hlísdi	For you both to recognize yourselves
ᎢᎦᏓᏙᎵᏍᏗ	ì:gada:do:hlísdi	For all of us to recognize ourselves
ᎣᎦᏓᏙᎵᏍᏗ	ò:gada:do:hlísdi	For them and me to recognize ourselves
ᏗᏥᎪᏩᏔ	diji:gò:wahta	Let you all see them (inanimate)
ᎤᎾᏓᏙᎵᏍᏗ	ù:nada:do:hlísdi	For them to recognize themselves
ᎣᎩᎾᏓᏙᎵᏍᏗ	ò:ginada:do:hlísdi	For him and me to recognize ourselves
ᎡᎦᏚᎳ	è:gadǔ:lā	All of us were recently wanted
ᎨᏂᎪᎲᎢ	ge:ni:go:hv̌:ɂi	You (1) and I saw them (animate) a while ago
ᎡᏍᏓᏚᎳ	è:sdadǔ:lā	You both recently wanted him; You both were recently wanted
ᎨᏗᎪᎲᎢ	ge:di:go:hv̌:ɂi	All of us saw them (animate) a while ago
ᎡᎩᎾᏚᎳ	è:ginadǔ:lā	You (1) and I were recently wanted
ᎨᏥᎪᎲᎢ	ge:ji:go:hv̌:ɂi	You all saw them (animate) a while ago; They were seen a while ago
ᎨᏍᏗᎪᎲᎢ	ge:sdi:go:hv̌:ɂi	You both saw them (animate) a while ago; They saw you both a while ago
ᎬᎩᎪᏩᏔ	gv:gigò:wahtā	They recently saw me
ᎠᏂᎴᎦ	à:ní:lè:ga	They are climbing it
ᏚᎾᎠ	du:náɂa	He has flexible things
ᎡᏙᏓ	e:do:da	Father
ᏧᏗᏔᏍᏗ	ju:di:tasdi	For him to drink drinks
ᏓᎾᏓᎦᏙᏍᏓ	dà:nadaktǒ:sdā	They recently looked at each other
ᎣᏥᎴᎦ	ò:jí:lè:ga	They and I are climbing it
ᎦᏚᎦ	gaɂdǔ:gā	I recently drank something alcoholic
ᏕᎾᏓᎦᏙᏍᏓ	dé:nadaktǒ:sdā	You (1) and I recently looked at each other
ᎣᏍᏗᎴᎦ	ò:sdí:lè:ga	He and I are climbing it
ᎬᏲᎵᏨᎢ	gv:yo:li:jv̌:ɂi	I recognized you (1) a while ago
ᏕᎦᎦᏙᏍᏗ	de:gagà:tǒ:sdi	I am looking at them (inanimate)
ᏕᏓᏓᎦᏙᏍᏓ	dé:dadaktǒ:sdā	All of us recently looked at each other
ᏘᏚᎲᎦ	tìdu:hv̀:ga	Let you (1) bake things
ᏕᎦᏓᎧᎰᎢ	dé:gada:kahó:ɂi	All of us usually have each other
ᏥᏲᎵᏨᎢ	ji:yo:li:jv̌:ɂi	I recognized him a while ago
ᏙᏣᏓᎦᏙᏍᏓ	dò:jadaktǒ:sdā	They and I recently looked at each other
ᏙᎦᏓᎧᎰᎢ	dò:gada:kahó:ɂi	They and I usually have each other
ᏍᏛᏲᎵᏨᎢ	sdv:yo:li:jv̌:ɂi	I recognized you both a while ago; We two recognized you (1) or you both a while ago
ᏙᏍᏓᏓᎦᏙᏍᏓ	dò:sdadaktǒ:sdā	He and I recently looked at each other
ᏚᎾᏓᎧᎰᎢ	dù:nada:kahó:ɂi	They usually have each other
ᏣᎦᏙᏍᏗ	jà:ktǒ:sdi	He is looking at you (1)
ᎦᏥᏲᎵᏨᎢ	gaji:yo:li:jv̌:ɂi	I recognized them (animate) a while ago
ᏗᎦᏚᎩᏍᏗ	digatǔ:gî:sdi	For all of us to drink alcoholic drinks
ᏕᎯᏍᏗᎦ	de:hisdǐ:gā	You (1) recently ate rod shaped things
ᎨᏦᎵᏍᏗ	gé:jo:lí:sdi	For them to recognize you all
ᏙᎩᎾᏓᎧᎰᎢ	dò:ginada:kahó:ɂi	He and I usually have each other
ᏕᏣᏓᏙᎵᏨᎢ	dé:jada:dohljv̌:ɂi	You all were acquainted a while ago
ᏗᎩᎾᏚᎩᏍᏗ	diginatǔ:gî:sdi	For you (1) and me to drink alcoholic drinks
ᏍᏛᏌ	sdv̋:sa	You both alone
ᎪᏦᎵᏍᏗ	go:jo:lí:sdi	For them and me to recognize them (animate)
ᏧᎾᏚᎸᏗ	jù:naduhldi	For them to want them
ᏕᏍᏓᏓᏙᎵᏨᎢ	de:sdada:dohljv̌:ɂi	You both were acquainted a while ago
ᎭᏓᎦᏙᏍᏗ	hadà:ktǒ:sdi	You (1) are looking at yourself
ᎢᏨᏌ	ì:jv̋:sa	You all alone
ᏗᏥᏍᏗᎦ	diji:sdǐ:ga	Let you all eat rod shaped things
ᎪᏍᏙᎵᏍᏗ	go:sdo:lí:sdi	For him and me to recognize them (animate)
ᎩᎾᏓᎪᏩᏛᏗ	ginada:gowhtv́hdi	For you (1) and me to see ourselves
ᎠᎾᏓᎦᏙᏍᏗ	à:nadà:ktǒ:sdi	They are looking at themselves
ᏕᏨᏲᎢ	dé:jù:wǎ:yóɂi	You all usually have rod shaped things
ᎢᎾᏓᎦᏙᏍᏗ	ì:nadà:ktǒ:sdi	You (1) and I are looking at ourselves
ᎢᎩᏘᏗ	ì:gì:tdi	For all of us to bake something
ᏕᏍᏛᏲᎢ	de:sdù:wǎ:yóɂi	You both usually have rod shaped things
ᎢᏓᏓᎦᏙᏍᏗ	ì:dadà:ktǒ:sdi	All of us are looking at ourselves
ᎣᎩᏘᏗ	ò:gì:tdi	For them and me to bake something
ᏫᏗᏥᏚᎲᎦ	widijìdu:hv̀:ga	Let me bake things
ᏍᏉᎵᎩ	sgwohlgi	Let you (1) recognize me
ᏫᏦᏦᎵᎩ	wijò:johlgi	Let them and me understand things
ᏫᏗᎪᎵᎩ	widigohlgi	Let him understand things; Let him recognize them (animate)
ᏫᏗᏃᎵᎩ	widinohlgi	Let them understand things; Let them recognize them (animate)
ᏫᏦᏍᏙᎵᎩ	wijò:sdohlgi	Let him and me understand things
ᏕᎪᎵᎦ	de:gohlgā	He recently understood things; He recently recognized them (animate)
ᎨᏂᎪᏩᏔ	ge:ni:gò:wahta	Let you (1) and me see them (animate)
ᎨᏗᎪᏩᏔ	ge:di:gò:wahta	Let all of us see them (animate)
ᎨᏥᎪᏩᏔ	ge:ji:gò:wahta	Let you all see them (animate)
ᎨᏍᏗᎪᏩᏔ	ge:sdi:gò:wahta	Let you both see them (animate)
ᏗᏍᏗᎪᏩᏔ	disdi:gò:wahta	Let you both see them (inanimate)
ᏍᎩᎾᏚᎳ	sginadǔ:la	Let you (1) or both want us both
ᎤᎪᎲᎢ	ù:go:hv̌:ɂi	He saw him a while ago; He saw it a while ago
ᎡᎩᎪᎲᎢ	è:gi:go:hv̌:ɂi	All of us were seen a while ago
ᎡᏂᎪᎲᎢ	è:ni:go:hv̌:ɂi	You (1) and I saw him a while ago
ᎡᏗᎪᎲᎢ	è:di:go:hv̌:ɂi	All of us saw him a while ago
ᎡᏥᎪᎲᎢ	è:ji:go:hv̌:ɂi	You all saw him a while ago; You all were seen a while ago
ᏕᎩᎾᏚᎳ	de:ginadǔ:lā	You (1) and I recently wanted them (inanimate)
ᎡᏍᏗᎪᎲᎢ	è:sdi:go:hv̌:ɂi	You both saw him a while ago; You both were seen a while ago
ᎡᎩᏂᎪᎲᎢ	è:gini:go:hv̌:ɂi	You (1) and I were seen a while ago
ᎢᎩᏥ	ì:gi:ji	Your all's and my mother
ᎠᏂᎷᎦ	à:ni:lù:gā	They recently climbed it
ᏚᏁᎰᎢ	du:ne:hó:ɂi	He usually has liquid things
ᏫᏗᎦᎦᏙᏍᏓ	widigagà:tǒ:sda	Let me look at them (inanimate)
ᏓᎾᏓᎪᏩᏘᏍᎪᎢ	dà:nada:gowhtǐ:sgóɂi	They are often seeing each other
ᎤᎮᏍᏗ	ù:hé:sdi	He will be having something solid
ᎣᏥᎷᎦ	ò:ji:lù:gā	They and I recently climbed it
ᏔᎭᏗᏔ	ta:dǐ:ta	Let you (1) drink drinks
ᏗᏊᏗᏔᏍᏗ	dìgwa:di:tasdi	For me to drink drinks
ᏕᎾᏓᎪᏩᏘᏍᎪᎢ	dé:nada:gowhtǐ:sgóɂi	You (1) and I are often seeing each other
ᎣᏍᏗᎷᎦ	ò:sdi:lù:gā	He and I recently climbed it
ᏗᏗᎭᏗᏔ	dida:dǐ:ta	Let all of us drink drinks
ᏕᏓᏓᎪᏩᏘᏍᎪᎢ	dé:dada:gowhtǐ:sgóɂi	All of us are often seeing each other
ᏗᏂᎭᏗᏔ	dína:dǐ:ta	Let you (1) and me drink drinks
ᏕᎦᏓᎧᎲᎢ	dé:gada:kahv̌:ɂi	All of us had each other a while ago
ᏙᏣᏓᎪᏩᏘᏍᎪᎢ	dò:jada:gowhtǐ:sgóɂi	They and I are often seeing each other
ᏍᏓᏓ	sdada	Let you both say
ᏫᏦᏥᎭᏗᏔ	wijò:ja:dǐ:ta	Let them and me drink drinks
ᏙᏍᏓᏓᎪᏩᏘᏍᎪᎢ	dò:sdada:gowhtǐ:sgóɂi	He and I are often seeing each other
ᎢᏣᏓ	ì:jada	Let you all say
ᏫᏗᏂᎭᏗᏔ	widina:dǐ:ta	Let them drink drinks
ᎠᏓᎪᏩᏘᎭ	à:da:gowhtíha	He is seeing himself
ᏫᏦᏍᏗᎭᏗᏔ	wijò:sda:dǐ:ta	Let him and me drink drinks
ᎭᏓᎪᏩᏘᎭ	hada:gowhtíha	You (1) are seeing yourself
ᎨᏦᎵᏨᎢ	gé:jo:li:jv̌:ɂi	They recognized you all a while ago
ᏗᏣᏟᏐᏗ	dijàhlǐ:sóhdi	For you (1) to gather things
ᏫᏓᎦᏙᏍᏓ	widaktǒ:sda	Let him look at them
ᏗᏥᏯᎦ	diji:hyaga	Let you all eat flexible things
ᎠᎾᏓᎪᏩᏘᎭ	à:nada:gowhtíha	They are seeing themselves
ᎪᏦᎵᏨᎢ	go:jo:li:jv̌:ɂi	They and I recognized them (animate) a while ago
ᏗᏣᏓᎦᏙᏍᏓ	dijadaktǒ:sda	Let you all look at each other
ᎨᎪᎵᏨᎢ	ge:gohljv̌:ɂi	They recognized all of us a while ago
ᎢᎾᏓᎪᏩᏘᎭ	ì:nada:gowhtíha	You (1) and I are seeing ourselves
ᎪᏍᏙᎵᏨᎢ	go:sdo:li:jv̌:ɂi	He and I recognized them (animate) a while ago
ᏕᏨᏴᎢ	dé:jù:wǎ:yv́:ɂi	You all had rod shaped things a while ago
ᏗᏍᏗᏍᏗᎦ	disdi:sdǐ:ga	Let you both eat rod shaped things
ᎯᏲᎵᏍᏗ	hi:yo:lí:sdi	For you (1) to recognize him
ᏦᎩᎪᏩᏛᏗ	jò:gi:gowhtv́hdi	For them and me to see them (inanimate)
ᎪᎪᎵᏨᎢ	go:gohljv̌:ɂi	They recognized them and me a while ago
ᎢᏓᏓᎪᏩᏘᎭ	ì:dada:gowhtíha	All of us are seeing ourselves
ᎢᏨᏲᎵᏍᏗ	ì:jv:yo:lí:sdi	For us, me, two, or we all to recognize you all; For we all to recognize you (1), two
ᏧᏂᎪᏩᏛᏗ	jù:ni:gowhtv́hdi	For them to see them
ᎣᏣᏓᎪᏩᏘᎭ	ò:jada:gowhtíha	They and I are seeing ourselves
ᏍᎩᎧᎭ	sgikáha	You (1) have me
ᎢᏍᎩᏲᎵᏍᏗ	ì:sgi:yo:lí:sdi	For you (1), two, or all to recognize us all; For you all to recognize me
ᏦᎩᏂᎪᏩᏛᏗ	jò:gini:gowhtv́hdi	For him and me to see them (inanimate)
ᎨᎩᏃᎵᏨᎢ	ge:ginohljv̌:ɂi	They recognized you (1) and me a while ago
ᎣᏍᏓᏓᎪᏩᏘᎭ	ò:sdada:gowhtíha	He and I are seeing ourselves
ᎥᎩᎧᎭ	v̀:gikáha	Someone has me
ᎦᎯᏲᎵᏍᏗ	gahi:yo:lí:sdi	For you (1) to recognize them (animate)
ᎪᎩᏃᎵᏨᎢ	go:ginohljv̌:ɂi	They recognized him and me a while ago
ᎩᎾᏓᏙᎵᏨᎢ	ginada:dohljv̌:ɂi	You (1) and I recognized ourselves a while ago
ᏣᎰᎢ	jahó:ɂi	You (1) usually have something solid
ᎠᎩᎰᎢ	à:gihó:ɂi	I usually have something solid
ᏫᎦᏓᏙᎵᎩ	wigada:do:lì:gi	Let me recognize myself
ᎠᏥᎪᏗ	à:jikóhdi	For someone to have him
ᏓᏃᎵᎦ	dà:nohlga	They understand things; They recognize them (animate)
ᏕᏃᎵᎦ	dé:nohlga	You (1) and I understand things
ᏕᏙᎵᎦ	dé:dohlga	All of us understand things
ᏙᏦᎵᎦ	dò:johlga	They and I understand things
ᎤᏓᏙᎵᏍᏗ	ù:da:do:hlísdi	For him to recognize himself
ᏙᏍᏙᎵᎦ	dò:sdohlga	He and I understand things
ᏣᏓᏙᎵᏍᏗ	jada:do:hlísdi	For you (1) to recognize yourself
ᎠᏆᏓᏙᎵᏍᏗ	à:gwada:do:hlísdi	For me to recognize myself
ᏍᎩᎾᏚᎳ	sginadǔ:la	Let you both want me
ᎡᎩᎪᏩᏔ	è:gi:gò:wahta	Let all of us be seen
ᎡᏂᎪᏩᏔ	è:ni:gò:wahta	Let you (1) and me see him
ᎡᏗᎪᏩᏔ	è:di:gò:wahta	Let all of us see him
ᎡᏥᎪᏩᏔ	è:ji:gò:wahta	Let you all see him; Let you all be seen
ᎡᏍᏗᎪᏩᏔ	è:sdi:gò:wahta	Let you both see him; Let you both be seen
ᎡᎩᏂᎪᏩᏔ	è:gini:gò:wahta	Let you (1) and me be seen
ᏕᎩᎪᎲᎢ	dé:gi:go:hv̌:ɂi	All of us saw them (inanimate) a while ago
ᏙᎩᎪᎲᎢ	dò:gi:go:hv̌:ɂi	They and I saw them (inanimate) a while ago
ᏚᏂᎪᎲᎢ	dù:ni:go:hv̌:ɂi	They saw them a while ago
ᏓᎩᎪᎲᎢ	dà:gigo:hv̌:ɂi	I saw them (inanimate) a while ago
ᏕᏣᎪᎲᎢ	de:jago:hv̌:ɂi	You (1) saw them (inanimate) a while ago
ᏕᎩᏂᎪᎲᎢ	de:gini:go:hv̌:ɂi	You (1) and I saw them (inanimate) a while ago
ᏙᎩᏂᎪᎲᎢ	dò:gini:go:hv̌:ɂi	He and I saw them (inanimate) a while ago
ᎢᏥᏥ	ì:ji:ji	Your all's mother
ᏚᏁᎲᎢ	du:ne:hv̌:ɂi	He had liquid things a while ago
ᎤᎸᏒᎢ	ù:lv̂:sv̌:ɂi	He climbed it a while ago
ᏓᏗᏔᏍᎦ	dà:di:tásga	He is drinking drinks
ᏦᎩᏍᏗᎩᏍᏗ	jò:gi:sdǐ:gî:sdi	For them and me to eat rod shaped things
ᏕᎩᎮᏍᏗ	dé:gi:hé:sdi	All of us will be having solid things
ᎮᎪᎢ	hé:góɂi	You (1) usually are going
ᏗᏧᏗᏔᏍᏗ	dija:di:tasdi	For you (1) to drink drinks; For you all to drink drinks
ᏧᏂᏍᏗᎩᏍᏗ	jù:ni:sdǐ:gî:sdi	For them to eat rod shaped things
ᎢᏂᎴᎦ	ì:ní:lè:ga	You (1) and I are climbing it
ᏙᎩᎮᏍᏗ	dò:gi:hé:sdi	They and I will be having solid things
ᏦᎩᏂᏍᏗᎩᏍᏗ	jò:gini:sdǐ:gî:sdi	For him and me to eat rod shaped things
ᎢᏗᎴᎦ	ì:dí:lè:ga	All of us are climbing it
ᏚᏂᎮᏍᏗ	dù:ni:hé:sdi	They will be having solid things
ᏓᎩᎮᏍᏗ	dà:gihé:sdi	I will be having solid things
ᏕᏣᏓᏚᎵᎭ	dé:jadadu:líha	You all are wanting each other
ᎪᏍᏓᎦᏙᏍᏗ	go:sdagà:tǒ:sdi	He and I are looking at them (animate)
ᎠᏓᎦᏙᏍᏓ	à:daktǒ:sdā	He recently looked at himself
ᏕᏣᎮᏍᏗ	de:jahé:sdi	You (1) will be having solid things
ᎩᎾᏓᏚᎵᎭ	ginadadu:líha	You (1) and I are wanting ourselves
ᎠᎾᏓᎦᏙᏍᏓ	à:nadaktǒ:sdā	They recently looked at themselves
ᏗᏣᏓᎦᏙᏍᏙᏗ	dijadaktǒ:sdóhdi	For you all to look at each other
ᏕᎩᏂᎮᏍᏗ	de:gini:hé:sdi	You (1) and I will be having solid things
ᏕᏥᏍᏗᎦ	de:jisdǐ:gā	I recently ate rod shaped things
ᏫᏗᎦᎭᏗᏔ	widiga:dǐ:ta	Let me drink drinks
ᏧᏚᎩᏍᏗ	ju:tǔ:gî:sdi	For him to drink alcoholic drinks
ᎣᏣᏓᎦᏙᏍᏓ	ò:jadaktǒ:sdā	They and I recently looked at ourselves
ᏙᎩᏂᎮᏍᏗ	dò:gini:hé:sdi	He and I will be having solid things
ᏍᏓᏓ	sdadā	You both recently said
ᏔᎦᏙᏍᏓ	taktǒ:sda	Let you (1) look at them (inanimate)
ᎣᏍᏓᏓᎦᏙᏍᏓ	ò:sdadaktǒ:sdā	He and I recently looked at ourselves
ᏕᏣᏚᎦ	dé:jatǔ:gā	You all recently drank alcoholic drinks
ᎭᏓᎦᏙᏍᏓ	hadaktǒ:sda	Let you (1) look at yourself
ᏕᏍᏓᏚᎦ	de:sdatǔ:gā	You both recently drank alcoholic drinks
ᎢᏨᏲᎵᏨᎢ	ì:jv:yo:li:jv̌:ɂi	I, we two, or we all recognized you all a while ago; We all recognized you (1), two a while ago
ᏗᏓᎦᏙᏍᏓ	didaktǒ:sda	Let all of us look at them (inanimate)
ᎢᏍᎩᏲᎵᏨᎢ	ì:sgi:yo:li:jv̌:ɂi	You (1), two, or all recognized us all a while ago; You all recognized me a while ago
ᏗᎾᎦᏙᏍᏓ	dínaktǒ:sda	Let you (1) and me look at them (inanimate)
ᏍᏛᎪᏩᏛᏗ	sdv:gowhtv́hdi	For me to see you both; For we two to see you (1) or you both
ᎦᏓᎪᏩᏘᎭ	gada:gowhtíha	I am seeing myself
ᎦᎯᏲᎵᏨᎢ	gahi:yo:li:jv̌:ɂi	You (1) recognized them (animate) a while ago
ᏗᎩᎪᏩᏛᏗ	digi:gowhtv́hdi	For all of us to see them (inanimate)
ᏕᎨᎩᎧᎭ	de:ge:gi:káha	They have all of us
ᎢᎦᏓᎪᏩᏛᏗ	ì:gada:gowhtv́hdi	For all of us to see ourselves
ᏫᏦᏣᎦᏙᏍᏓ	wijò:jaktǒ:sda	Let them and me look at them (inanimate)
ᏕᎪᎩᎧᎭ	de:go:gi:káha	They have them and me
ᎣᎦᏓᎪᏩᏛᏗ	ò:gada:gowhtv́hdi	For them and me to see ourselves
ᎪᎵᎪᎢ	go:li:gó:ɂi	I usually understand it
ᏫᏗᎾᎦᏙᏍᏓ	widinaktǒ:sda	Let them look at them
ᏣᎲᎢ	jahv̌:ɂi	You (1) had something solid a while ago
ᏕᎬᎩᎧᎭ	de:gv:gikáha	They have me
ᎤᎾᏓᎪᏩᏛᏗ	ù:nada:gowhtv́hdi	For them to see themselves
ᏫᏦᏍᏓᎦᏙᏍᏓ	wijò:sdaktǒ:sda	Let him and me look at them (inanimate)
ᎠᎩᎲᎢ	à:gihv̌:ɂi	I had something solid a while ago
ᏕᎨᎩᏂᎧᎭ	de:ge:gini:káha	They have you (1) and me
ᏗᎩᏂᎪᏩᏛᏗ	digini:gowhtv́hdi	For you (1) and me to see them (inanimate)
ᏕᎪᎩᏂᎧᎭ	de:go:gini:káha	They have him and me
ᎣᎩᎾᏓᎪᏩᏛᏗ	ò:ginada:gowhtv́hdi	For him and me to see ourselves
ꭼꮿᎪᏗ	gv:ya:kóhdi	For me to have you (1)
ꮵꮿᎪᏗ	ji:ya:kóhdi	For me to have something alive
ꭶꮵꮿᎪᏗ	gaji:ya:kóhdi	For me to have living things
ᏙᏍᏙᎵᎦ	dò:sdohlgā	He and I recently understood things
ᏫᎨᏥᎪᏩᏔ	wige:ji:gò:wahta	Let them be seen
ᎡᎩᏂᎪᏩᏔ	è:gini:gò:wahtā	You (1) and I were recently seen
ᎢᏂᎷᎦ	ì:ni:lù:ga	Let you (1) and me climb it
ᎤᎸᏍᏗ	ù:lv̀:sdi	For him to climb it
ᎢᏨᏥ	ì:jv:ji	I, your all's mother
ᏕᏥᏯᎦ	de:jiyagā	I recently ate flexible things
ᏓᎭᏗᏔ	da:dǐ:tā	He recently drank drinks
ᎨᎦᎦᏙᏍᏙᏗ	ge:gagà:tǒ:sdóhdi	For them to be looked at
ᎦᏓᎦᏙᏍᏗᏍᎪᎢ	gadà:gà:tǒ:sdí:sgó:ɂi	I am often looking at myself
ᏣᏁᏗ	janehdi	For you (1) to have a liquid
ᎢᏗᎷᎦ	ì:di:lù:ga	Let all of us climb it
ᏕᎩᎾᎠ	dé:gi:náɂa	All of us have flexible things
ᏥᏰᎠ	jiyé:ɂa	I am eating something flexible
ᎠᎩᏁᏗ	à:ginehdi	For me to have a liquid
ᏙᎩᎾᎠ	dò:gi:náɂa	They and I have flexible things
ᏚᏂᎾᎠ	dù:ni:náɂa	They have flexible things
ᏦᎫᏗᏔᏍᏗ	jò:ga:di:tasdi	For them and me to drink drinks
ᏓᎩᎾᎠ	dà:gináɂa	I have flexible things
ᏧᏄᏗᏔᏍᏗ	jù:na:di:tasdi	For them to drink drinks
ᏗᎩᏍᏗᎩᏍᏗ	digi:sdǐ:gî:sdi	For all of us to eat rod shaped things
ᏕᏣᎾᎠ	de:janáɂa	You (1) have flexible things
ᏦᎩᏄᏗᏔᏍᏗ	jò:gina:di:tasdi	For him and me to drink drinks
ᏗᎩᏂᏍᏗᎩᏍᏗ	digini:sdǐ:gî:sdi	For you (1) and me to eat rod shaped things
ᏕᏣᏓᏚᎸᎲᎢ	dé:jadadu:lv:hv̌:ɂi	You all wanted each other a while ago
ᏧᏚᎸᏗ	ju:duhldi	For him to want them
ᎢᎦᏓᏙᎵᏨᎢ	ì:gada:dohljv̌:ɂi	All of us recognized ourselves a while ago
ᎣᎦᏓᏙᎵᏨᎢ	ò:gada:dohljv̌:ɂi	They and I recognized ourselves a while ago
ᎤᎾᏓᏙᎵᏨᎢ	ù:nada:dohljv̌:ɂi	They recognized themselves a while ago
ᎨᏣᎦᏙᏍᏗ	ge:jà:ktǒ:sdi	They are looking at you (1)
ᎣᎩᎾᏓᏙᎵᏨᎢ	ò:ginada:dohljv̌:ɂi	He and I recognized ourselves a while ago
ᏕᎨᏥᎧᎭ	de:gé:ji:káha	They have you all
ᏕᎪᏥᎧᎭ	de:go:ji:káha	They and I have living things
ᏕᎪᏍᏗᎧᎭ	de:go:sdi:káha	He and I have living things
ᎤᏓᎪᏩᏛᏗ	ù:da:gowhtv́hdi	For him to see himself
ᏕᏍᏓᏓᎧᎭ	de:sdada:káha	You both have each other
ᏣᏓᎪᏩᏛᏗ	jada:gowhtv́hdi	For you (1) to see yourself
ᏗᏣᎪᏩᏛᏗ	dijagowhtv́hdi	For you (1) to see them (inanimate)
ᏗᎩᎪᏩᏛᏗ	dìgigowhtv́hdi	For me to see them (inanimate)
ᎠᏆᏓᎪᏩᏛᏗ	à:gwada:gowhtv́hdi	For me to see myself
ᎯᏯᏚᎳ	hi:yadǔ:la	Let you (1) want him
ᎢᏍᎩᏯᏚᎳ	ì:sgi:yadǔ:la	Let you (1), two, or all want us all; Let you all want me
ᎦᎯᏯᏚᎳ	gahi:yadǔ:la	Let you (1) want them (animate)
ᏍᎩᎪᏩᏔ	sgigò:wahta	Let you (1) see me
ᎣᎩᏥ	o:gi:ji	Their and my mother
ᎨᎦᎦᏙᏍᏔᏅᎢ	ge:gà:gà:tǒ:stánv̌:ɂi	They were looked at a while ago
ᏕᎩᏁᎰᎢ	dé:gi:ne:hó:ɂi	All of us usually have liquid things
ᏙᎩᏁᎰᎢ	dò:gi:ne:hó:ɂi	They and I usually have liquid things
ᏗᎩᏁᏗ	dì:gi:nehdi	For all of us to have a liquid
ᏚᏂᏁᎰᎢ	dù:ni:ne:hó:ɂi	They usually have liquid things
ᏦᎩᏁᏗ	jò:gi:nehdi	For them and me to have a liquid
ᎢᏗᎷᎦ	ì:di:lù:gā	All of us recently climbed it
ᏓᎩᏁᎰᎢ	dà:gine:hó:ɂi	I usually have liquid things
ᏧᏂᏁᏗ	jù:ni:nehdi	For them to have a liquid
ᎦᎴᎦ	gálè:ga	He is climbing it
ᏕᏣᏁᎰᎢ	de:jane:hó:ɂi	You (1) usually have liquid things
ᏦᎩᏂᏁᏗ	jò:gini:nehdi	For him and me to have a liquid
ᏕᎩᏂᏁᎰᎢ	de:gini:ne:hó:ɂi	You (1) and I usually have liquid things
ᏕᎦᏯᎦ	de:gahyagā	He recently ate flexible things
ᏗᎫᏗᏔᏍᏗ	diga:di:tasdi	For all of us to drink drinks
ᏗᏣᏍᏗᎩᏍᏗ	dijasdǐ:gî:sdi	For you (1) to eat rod shaped things
ᏙᎩᏂᏁᎰᎢ	dò:gini:ne:hó:ɂi	He and I usually have liquid things
ᏗᎩᏄᏗᏔᏍᏗ	digina:di:tasdi	For you (1) and me to drink drinks
ᏗᎩᏍᏗᎩᏍᏗ	dìgisdǐ:gî:sdi	For me to eat rod shaped things
ᎠᎾᏓᎪᏩᏘᏍᎪᎢ	à:nada:gowhtǐ:sgóɂi	They are often seeing themselves
ᎤᎾᎠ	ù:náɂa	He has something flexible
ᏕᎨᏣᎧᎰᎢ	de:ge:jakahó:ɂi	They usually have you (1)
ᏗᏥᎭᏗᏔ	dija:dǐ:ta	Let you all drink drinks
ᎢᎦᏓᏚᎵᎭ	ì:gadadu:líha	All of us are wanting ourselves
ᎬᏯᎦᏙᏍᏗ	gv:yagà:tǒ:sdi	I am looking at you (1)
ᎣᎦᏓᏚᎵᎭ	ò:gadadu:líha	They and I are wanting ourselves
ᏥᏯᎦᏙᏍᏗ	ji:yagà:tǒ:sdi	I am looking at him
ᎤᎾᏓᏚᎵᎭ	ù:nadadu:líha	They are wanting themselves
ᎦᏥᏯᎦᏙᏍᏗ	gaji:yagà:tǒ:sdi	I am looking at them (animate)
ᎣᎩᎾᏓᏚᎵᎭ	ò:ginadadu:líha	He and I are wanting ourselves
ᏕᏣᏓᎪᏩᏘᎭ	dé:jada:gowhtíha	You all are seeing each other
ᏕᏍᏓᏓᎪᏩᏘᎭ	de:sdada:gowhtíha	You both are seeing each other
ᎠᎩᏘᏗ	à:gìtdi	For me to bake something
ᏍᏗᎰᎢ	sdi:hó:ɂi	You both usually have something solid
ᎢᏥᎰᎢ	ì:ji:hó:ɂi	You all usually have something solid
ᎤᏓᏙᎵᏨᎢ	ù:da:dohljv̌:ɂi	He recognized himself a while ago
ᏣᏓᏙᎵᏨᎢ	jada:dohljv̌:ɂi	You (1) recognized yourself a while ago
ᎠᏆᏓᏙᎵᏨᎢ	à:gwada:dohljv̌:ɂi	I recognized myself a while ago
ᎢᏣᏓᏙᎵᎩ	ì:jada:dohlgi	Let you all recognize yourselves
ᏗᏍᏙᎵᏍᏗ	disdo:hlísdi	For you both to understand things
ᏕᏥᎪᎲᎢ	dé:ji:go:hv̌:ɂi	You all saw them (inanimate) a while ago
ᏕᏍᏗᎪᎲᎢ	de:sdi:go:hv̌:ɂi	You both saw them (inanimate) a while ago
ᎤᏂᏥ	u:ni:ji	Their mother
ᏕᎩᏁᎲᎢ	dé:gi:ne:hv̌:ɂi	All of us had liquid things a while ago
ᏕᎦᏗᏔᏍᎦ	de:gà:di:tásga	I am drinking drinks
ᎠᎾᏗᎭ	à:nadiha	They are saying
ᏙᎩᏁᎲᎢ	dò:gi:ne:hv̌:ɂi	They and I had liquid things a while ago
ᎢᎾᏗᎭ	ì:nadiha	You (1) and I are saying
ᏚᏂᏁᎲᎢ	dù:ni:ne:hv̌:ɂi	They had liquid things a while ago
ᎢᏓᏗᎭ	ì:dadiha	All of us are saying
ᏓᎩᏁᎲᎢ	dà:gine:hv̌:ɂi	I had liquid things a while ago
ᎦᎷᎦ	galù:gā	He recently climbed it
ᏕᏣᏁᎲᎢ	de:jane:hv̌:ɂi	You (1) had liquid things a while ago
ᎠᏓᎦᏙᏍᏗᏍᎪᎢ	à:dà:ktǒ:sdí:sgó:ɂi	He is often looking at himself
ᏥᎴᎦ	jílè:ga	I am climbing it
ᏕᎩᏂᏁᎲᎢ	de:gini:ne:hv̌:ɂi	You (1) and I had liquid things a while ago
ᎭᏓᎦᏙᏍᏗᏍᎪᎢ	hadà:ktǒ:sdí:sgó:ɂi	You (1) are often looking at yourself
ᎠᎾᏓᎦᏙᏍᏗᏍᎪᎢ	à:nadà:ktǒ:sdí:sgó:ɂi	They are often looking at themselves
ᏬᏍᏓᏓ	wò:sdada	Let him and me say
ᎤᏁᎰᎢ	ù:ne:hó:ɂi	He usually has a liquid
ᏕᎨᏣᎧᎲᎢ	de:ge:jakahv̌:ɂi	They had you (1) a while ago
ꮷꮹᏟᏐᏗ	ju:wà:hlǐ:sóhdi	For him to gather things
ᎢᎾᏓᎦᏙᏍᏗᏍᎪᎢ	ì:nadà:ktǒ:sdí:sgó:ɂi	You (1) and I are often looking at ourselves
ᏕᏣᏓᎧᎰᎢ	dé:jada:kahó:ɂi	You all usually have each other
ᎣᎦᏓᏚᎸᎲᎢ	ò:gadadu:lv:hv̌:ɂi	They and I wanted ourselves a while ago
ᎢᏓᏓᎦᏙᏍᏗᏍᎪᎢ	ì:dadà:ktǒ:sdí:sgó:ɂi	All of us are often looking at ourselves
ᎤᎾᏓᏚᎸᎲᎢ	ù:nadadu:lv:hv̌:ɂi	They wanted themselves a while ago
ᎣᏣᏓᎦᏙᏍᏗᏍᎪᎢ	ò:jadà:ktǒ:sdí:sgó:ɂi	They and I are often looking at ourselves
ᎣᎩᎾᏓᏚᎸᎲᎢ	ò:ginadadu:lv:hv̌:ɂi	He and I wanted ourselves a while ago
ᎣᏍᏓᏓᎦᏙᏍᏗᏍᎪᎢ	ò:sdadà:ktǒ:sdí:sgó:ɂi	He and I are often looking at ourselves
ᏣᎦᏙᏍᏓ	jaktǒ:sdā	He recently looked at you (1)
ᎨᎦᏚᎵᎭ	ge:gadu:líha	They are wanting all of us; They are wanted
ᎪᎦᏚᎵᎭ	go:gadu:líha	They are wanting them and me
ᎨᏍᏓᎦᏙᏍᏗ	ge:sdagà:tǒ:sdi	You both are looking at them (animate); They are looking at you both
ᎬᏆᏚᎵᎭ	gv:gwadu:líha	They are wanting me
ᎠᏆᏓᏚᎵᎭ	à:gwadadu:líha	I am wanting myself
ᏍᏗᎲᎢ	sdi:hv̌:ɂi	You both had something solid a while ago
ᎨᎩᎾᏚᎵᎭ	ge:ginadu:líha	They are wanting you (1) and me
ᎢᏥᎲᎢ	ì:ji:hv̌:ɂi	You all had something solid a while ago
ᎪᎩᎾᏚᎵᎭ	go:ginadu:líha	They are wanting him and me
ᏗᏣᎦᏙᏍᏓ	dijaktǒ:sda	Let you all look at them (inanimate)
ꭼꮿᎧᎭ	gv:ya:káha	I have you (1)
ꮵꮿᎧᎭ	ji:ya:káha	I have something alive
ᏓᏃᎵᎪᎢ	dà:nohlgó:ɂi	They usually understand things; They usually recognize them (animate)
ꭶꮵꮿᎧᎭ	gaji:ya:káha	I have living things
ᏕᏃᎵᎪᎢ	dé:nohlgó:ɂi	You (1) and I usually understand things
ᏕᏙᎵᎪᎢ	dé:dohlgó:ɂi	All of us usually understand things
ᏗᏍᏙᎵᎩ	disdohlgi	Let you both understand things
ᏙᏦᎵᎪᎢ	dò:johlgó:ɂi	They and I usually understand things
ᏙᏍᏙᎵᎪᎢ	dò:sdohlgó:ɂi	He and I usually understand things
ᏕᏥᎪᏩᏔ	dé:ji:gò:wahtā	You all recently saw them (inanimate)
ᏕᏍᏗᎪᏩᏔ	de:sdi:gò:wahtā	You both recently saw them (inanimate)
ᎤᏙᏓ	u:do:da	His father
ᎩᏁᏅᏒᎢ	gine:nv́:sv̌:ɂi	You (1) and I went a while ago
ᏕᎭᏚᎩᎠ	de:hàtǔ:gía	You (1) are drinking alcoholic drinks
ᏙᎩᏁᎭ	dò:gi:néha	They and I have liquid things
ᎨᏣᎦᏙᏍᏓ	gé:jagà:tǒ:sdā	They recently looked at you all
ᎪᏣᎦᏙᏍᏓ	go:jagà:tǒ:sdā	They and I recently looked at them (animate)
ᏕᏍᏓᏓᏚᎵᏍᎪᎢ	de:sdadadu:lǐ:sgóɂi	You both usually are wanting each other
ᎯᎴᎦ	hílè:ga	You (1) are climbing it
ᎤᏁᎲᎢ	ù:ne:hv̌:ɂi	He had a liquid a while ago
ᏕᏥᎮᏍᏗ	dé:ji:hé:sdi	You all will be having solid things
ᏕᏍᏗᎮᏍᏗ	de:sdi:hé:sdi	You both will be having solid things
ᎨᎦᏚᎸᎲᎢ	ge:gadu:lv:hv̌:ɂi	They wanted all of us a while ago; They were wanted a while ago
ᏍᏛᎪᏩᏘᎭ	sdv:gowhtíha	I am seeing you both; We two are seeing you (1) or you both
ᏕᎨᏂᎧᎭ	de:ge:ni:káha	You (1) and I have living things
ᏗᏥᎪᏩᏛᏗ	diji:gowhtv́hdi	For you all to see them (inanimate)
ᎪᎵᎦ	gohlga	He understands it; He recognizes him
ᏕᎨᏗᎧᎭ	de:ge:di:káha	All of us have living things
ᏕᎨᏥᎧᎭ	de:ge:ji:káha	You all have living things; Someone has them
ᏕᎨᏍᏗᎧᎭ	de:ge:sdi:káha	You both have living things; They have you both
ᏮᎩᎪᏩᏔ	wv̀:gigò:wahta	Let me be seen
ᏍᎩᏂᎪᏩᏔ	sgini:gò:wahta	Let you (1) or both see us both
ᎦᎯᏥ	gahi:ji	You one, their mother
ᏕᏣᏅᏔ	de:janhta	You (1) know things
ᏚᎥᏰᏍᏗ	du:jv̌:yê:sdi	He will be having rod shaped things
ᎩᏁᏅᏍᏗ	gine:nv̀:sdi	For you (1) and me to go
ᏕᎩᏯᎥᎢ	dé:gi:hyá:ɂv̌:ɂi	All of us ate flexible things a while ago
ᏓᏗᏔᏍᎪᎢ	dà:di:tasgó:ɂi	He usually is drinking drinks
ᏕᎦᏚᎩᎠ	de:gaɂdǔ:gía	I am drinking alcoholic drinks
ᏙᎩᏯᎥᎢ	dò:gi:hyá:ɂv̌:ɂi	They and I ate flexible things a while ago
ᏤᏅᏒᎢ	je:nv́:sv̌:ɂi	You (1) went a while ago
ᏚᏂᏯᎥᎢ	dù:ni:hyá:ɂv̌:ɂi	They ate flexible things a while ago
ᎠᏇᏅᏒᎢ	à:gwe:nv́:sv̌:ɂi	I went a while ago
ᎯᎷᎦ	hilù:ga	Let you (1) climb it
ᎠᏁᎪᎢ	à:né:góɂi	They usually are going
ᏓᎩᏯᎥᎢ	dà:gihyá:ɂv̌:ɂi	I ate flexible things a while ago
ᎣᎨᏅᏒᎢ	ò:ge:nv́:sv̌:ɂi	They and I went a while ago
ᏕᎩᏂᏯᎥᎢ	de:gini:hyá:ɂv̌:ɂi	You (1) and I ate flexible things a while ago
ᎤᏁᏅᏒᎢ	ù:ne:nv́:sv̌:ɂi	They went a while ago
ᏙᎩᏂᏯᎥᎢ	dò:gini:hyá:ɂv̌:ɂi	He and I ate flexible things a while ago
ᎣᎩᏁᏅᏒᎢ	ò:gine:nv́:sv̌:ɂi	He and I went a while ago
ᏕᎩᎾᏓᎧᎮᏍᏗ	de:ginada:kahé:sdi	You (1) and I will be having each other
ᏗᏥᏍᏗᎩᏍᏗ	diji:sdǐ:gî:sdi	For you all to eat rod shaped things
ᏗᏍᏓᏚᎩᏍᏗ	disdatǔ:gî:sdi	For you both to drink alcoholic drinks
ᏕᏥᎾᎠ	dé:ji:náɂa	You all have flexible things
ᏕᏍᏗᎾᎠ	de:sdi:náɂa	You both have flexible things
ᎢᏓᏚᎩ	ì:datǔ:gi	Let all of us drink something alcoholic
ᎨᏣᏚᎵᎭ	gé:jadu:líha	They are wanting you all
ᎪᏣᏚᎵᎭ	go:jadu:líha	They and I are wanting them (animate)
ᎪᏍᏓᏚᎵᎭ	go:sdadu:líha	He and I are wanting them (animate)
ᏍᏓᏓᏙᎵᏨᎢ	sdada:dohljv̌:ɂi	You both recognized yourselves a while ago
ᎪᎵᎦ	gohlgā	He recently understood it; He recently recognized him
ᏩᏥᎪᏩᏔ	wà:jigò:wahta	Let him be seen
ᏍᎩᏂᎪᏩᏔ	sgini:gò:wahta	Let you both see me
ᎬᏙᏓ	gv:do:da	I, your father
ᏚᎾᎣᎢ	du:náó:ɂi	He usually has flexible things
ᏕᎩᏚᏅᎢ	dé:gí:du:hnv̌:ɂi	All of us baked things a while ago
ᏤᏅᏍᏗ	je:nv̀:sdi	For you (1) to go
ᏙᎩᏚᏅᎢ	dò:gí:du:hnv̌:ɂi	They and I baked things a while ago
ᏕᎦᎭᏗᏔ	de:ga:dǐ:tā	I recently drank drinks
ᏓᎾᏚᎩᎠ	dà:nàtǔ:gía	They are drinking alcoholic drinks
ᎠᏇᏅᏍᏗ	à:gwe:nv̀:sdi	For me to go
ᏚᏂᏚᏅᎢ	dù:ní:du:hnv̌:ɂi	They baked things a while ago
ᏕᎾᏚᎩᎠ	dé:nàtǔ:gía	You (1) and I are drinking alcoholic drinks
ᎣᎨᏅᏍᏗ	ò:ge:nv̀:sdi	For them and me to go
ᏓᎩᏚᏅᎢ	dà:gídu:hnv̌:ɂi	I baked things a while ago
ᏕᏓᏚᎩᎠ	dé:dàtǔ:gía	All of us are drinking alcoholic drinks
ᎨᎾᎦᏙᏍᏓ	ge:nagà:tǒ:sda	Let you (1) and me look at them (animate)
ᎤᏁᏅᏍᏗ	ù:ne:nv̀:sdi	For them to go
ᎢᏁᎪᎢ	ì:né:góɂi	You (1) and I usually are going
ᏙᏣᏚᎩᎠ	dò:jàtǔ:gía	They and I are drinking alcoholic drinks
ᎨᏓᎦᏙᏍᏓ	ge:dagà:tǒ:sda	Let all of us look at them (animate)
ᎢᏕᎪᎢ	ì:dé:góɂi	All of us usually are going
ᎣᎩᏁᏅᏍᏗ	ò:gine:nv̀:sdi	For him and me to go
ᏙᏍᏓᏚᎩᎠ	dò:sdàtǔ:gía	He and I are drinking alcoholic drinks
ᎨᏣᎦᏙᏍᏓ	ge:jagà:tǒ:sda	Let you all look at them (animate)
ᏕᏣᏯᎥᎢ	de:jahyá:ɂv̌:ɂi	You (1) ate flexible things a while ago
ᎢᎨᏅᏒᎢ	ì:ge:nv́:sv̌:ɂi	All of us went a while ago
ᏕᏍᏓᏓᎦᏙᏍᏔᏅᎢ	de:sdadà:ktǒ:stánv̌:ɂi	You both looked at each other a while ago
ᎯᎷᎦ	hilù:gā	You (1) recently climbed it
ᏕᏥᏁᎰᎢ	dé:ji:ne:hó:ɂi	You all usually have liquid things
ᎩᏂᏰᏍᏗ	gini:hyè:sdi	For you (1) and me to eat something flexible
ᏕᏍᏗᏁᎰᎢ	de:sdi:ne:hó:ɂi	You both usually have liquid things
ᏕᎩᎧᎰᎢ	dè:gi:kahó:ɂi	Someone often has you all and me
ᏕᏂᎧᎰᎢ	dè:ni:kahó:ɂi	You (1) and I usually have something alive
ᏕᏗᎧᎰᎢ	dè:di:kahó:ɂi	All of us usually have something alive
ᎬᎪᏩᏘᎭ	gv:gowhtíha	I am seeing you (1)
ᎨᏣᎦᏙᏍᏓ	ge:jaktǒ:sdā	They recently looked at you (1)
ᏕᏥᎧᎰᎢ	dè:ji:kahó:ɂi	You all usually have something alive; Someone often has you all
ᏥᎪᏩᏘᎭ	ji:gowhtíha	I am seeing him
ᏕᏍᏗᎧᎰᎢ	dè:sdi:kahó:ɂi	You both usually have something alive; Someone often has you both
ᏣᎪᏩᏘᎭ	jagowhtíha	He is seeing you (1)
ᏕᎬᎩᎧᎰᎢ	de:gv:gikahó:ɂi	They usually have me
ᎦᏥᎪᏩᏘᎭ	gaji:gowhtíha	I am seeing them (animate)
ᏕᎩᏂᎧᎰᎢ	dè:gini:kahó:ɂi	Someone often has you (1) and me
ᏍᏛᏯᏚᎵᎭ	sdv:yadu:líha	I am wanting you both; We two are wanting you (1) or you both
ᎦᎦᏙᏍᏗ	gagà:tǒ:sdi	I am looking at it
ᏬᏍᏙᎵᎩ	wò:sdo:lì:gi	Let him and me recognize him
ꭿꮿᎧᎭ	hi:ya:káha	You (1) have something alive
ꭶꭿꮿᎧᎭ	gahi:ya:káha	You (1) have living things
ᏕꮝꭹꮿᎧᎭ	dé:sgi:ya:káha	You (1), two, or all have us all; You all have me
ᎠᏂᎪᏩᏔ	à:ni:gò:wahtā	They recently saw him; They recently saw it
ᎯᏙᏓ	hi:do:da	You one, his father
ᏕᏥᏰᏍᎪᎢ	de:jiyé:sgó:ɂi	I am usually eating flexible things
ᏓᏍᏗᎩᎠ	dàsdǐ:gíɂa	He is eating rod shaped things
ᏓᏆᏅᏔ	dà:gwanhta	I know things
ᏕᎩᎥᏰᏍᏗ	dé:gi:jv̌:yê:sdi	All of us will be having rod shaped things
ᏙᎩᎥᏰᏍᏗ	dò:gi:jv̌:yê:sdi	They and I will be having rod shaped things
ᏕᎯᎭᏗᏔ	de:ha:dǐ:tā	You (1) recently drank drinks
ᏚᏂᎥᏰᏍᏗ	dù:ni:jv̌:yê:sdi	They will be having rod shaped things
ᏕᎩᏂᎥᏰᏍᏗ	de:gini:jv̌:yê:sdi	You (1) and I will be having rod shaped things
ᎣᏣᏗᎭ	ò:jadiha	They and I are saying
ᏙᎩᏂᎥᏰᏍᏗ	dò:gini:jv̌:yê:sdi	He and I will be having rod shaped things
ᎢᎨᏅᏍᏗ	ì:ge:nv̀:sdi	For all of us to go
ᎣᏍᏓᏗᎭ	ò:sdadiha	He and I are saying
ᏕᏣᏚᏅᎢ	de:jádu:hnv̌:ɂi	You (1) baked things a while ago
ᎨᏍᏓᎦᏙᏍᏓ	ge:sdagà:tǒ:sda	Let you both look at them (animate)
ᎤᏓᏚᎵᏍᎪᎢ	ù:dadu:lǐ:sgóɂi	He usually is wanting himself
ᏍᏗᎴᎦ	sdí:lè:ga	You both are climbing it
ᎠᏂᏍᏗᎦ	à:ni:sdǐ:gā	They recently ate something rod shaped
ᏣᏓᏚᎵᏍᎪᎢ	jadadu:lǐ:sgóɂi	You (1) usually are wanting yourself
ᎢᏥᎴᎦ	ì:jí:lè:ga	You all are climbing it
ᎤᏩᏌ	uwǎ:sa	Himself
ᏕᏥᏁᎲᎢ	dé:ji:ne:hv̌:ɂi	You all had liquid things a while ago
ᎠᏆᏓᏚᎵᏍᎪᎢ	à:gwadadu:lǐ:sgóɂi	I am usually wanting myself
ᏕᏍᏗᏁᎲᎢ	de:sdi:ne:hv̌:ɂi	You both had liquid things a while ago
ᎣᎩᏰᏍᏗ	ò:gi:hyè:sdi	For them and me to eat something flexible
ᏥᏯᎦᏙᏍᏓ	ji:yagà:tǒ:sdā	I recently looked at him
ᎣᎩᏂᏰᏍᏗ	ò:gini:hyè:sdi	For him and me to eat something flexible
ᎦᏥᏯᎦᏙᏍᏓ	gaji:yagà:tǒ:sdā	I recently looked at them (animate)
ᏕᎩᎧᎲᎢ	dè:gi:kahv̌:ɂi	Someone had you all and me, we a while ago
ᏕᏂᎧᎲᎢ	dè:ni:kahv̌:ɂi	You (1) and I had something alive a while ago
ᏕᏗᎧᎲᎢ	dè:di:kahv̌:ɂi	All of us had something alive a while ago
ᏕᏥᎧᎲᎢ	dè:ji:kahv̌:ɂi	You all had something alive a while ago; Someone had you all a while ago
ᎡᏣᎦᏙᏍᏓ	è:jaktǒ:sdā	You (1) were recently looked at
ᏕᏍᏗᎧᎲᎢ	dè:sdi:kahv̌:ɂi	You both had something alive a while ago; Someone had you both a while ago
ᎯᎪᏩᏘᎭ	hi:gowhtíha	You (1) are seeing him
ᏕᎨᎩᎧᎰᎢ	de:ge:gi:kahó:ɂi	They usually have all of us
ᎢᏨᎪᏩᏘᎭ	ì:jv:gowhtíha	I, we two, or we all are seeing you all; We all are seeing you (1), two
ᏕᎪᎩᎧᎰᎢ	de:go:gi:kahó:ɂi	They usually have them and me
ᎢᏍᎩᎪᏩᏘᎭ	ì:sgi:gowhtíha	You (1), two, or all are seeing us all; You all are seeing me
ᏕᎨᎩᏂᎧᎰᎢ	de:ge:gini:kahó:ɂi	They usually have you (1) and me
ᎦᎯᎪᏩᏘᎭ	gahi:gowhtíha	You (1) are seeing them (animate)
ᏍᏛᏯᏚᎸᎲᎢ	sdv:yadu:lv:hv̌:ɂi	I wanted you both a while ago; We two wanted you (1) or you both a while ago
ᏕᎪᎩᏂᎧᎰᎢ	de:go:gini:kahó:ɂi	They usually have him and me
ᎠᎦᏚᎵᎭ	à:gadu:líha	He is wanted
ᎢᏣᏓᏙᎵᏨᎢ	ì:jada:dohljv̌:ɂi	You all recognized yourselves a while ago
ᎰᎵᎦ	hohlga	You (1) understand it
ᏦᎵᏍᏗ	jo:hlísdi	For you (1) to understand it; For him to recognize you (1)
ᏗᏍᏗᎪᏩᏛᏗ	disdi:gowhtv́hdi	For you both to see them (inanimate)
ᎢᏂᎪᏩᏔ	ì:ni:gò:wahta	Let you (1) and me see it
ᎢᏗᎪᏩᏔ	ì:di:gò:wahta	Let all of us see it
ᎩᏂᎪᎲᎢ	gini:go:hv̌:ɂi	He saw you (1) and me a while ago; You (1) and I saw it a while ago
ᎯᎠ	hiɂa	This, These; They, Them; He, Him
ᏕᎩᎾᎣᎢ	dé:gi:náó:ɂi	All of us usually have flexible things
ᏓᏂᏍᏗᎩᎠ	dà:nì:sdǐ:gíɂa	They are eating rod shaped things
ᏕᎭᏗᏔᏍᎪᎢ	de:hà:di:tasgó:ɂi	You (1) usually are drinking drinks
ᏙᎩᎾᎣᎢ	dò:gi:náó:ɂi	They and I usually have flexible things
ᏕᏂᏍᏗᎩᎠ	dé:nì:sdǐ:gíɂa	You (1) and I are eating rod shaped things
ᏚᏂᎾᎣᎢ	dù:ni:náó:ɂi	They usually have flexible things
ᏕᏗᏍᏗᎩᎠ	dé:dì:sdǐ:gíɂa	All of us are eating rod shaped things
ᏕᎩᏂᎾᎣᎢ	de:gini:náó:ɂi	You (1) and I usually have flexible things
ᏙᏥᏍᏗᎩᎠ	dò:jì:sdǐ:gíɂa	They and I are eating rod shaped things
ᏙᎩᏂᎾᎣᎢ	dò:gini:náó:ɂi	He and I usually have flexible things
ᏙᏍᏗᏍᏗᎩᎠ	dò:sdì:sdǐ:gíɂa	He and I are eating rod shaped things
ᏍᏗᎷᎦ	sdi:lù:ga	Let you both climb it
ᏕᎦᏰᏍᎪᎢ	de:gahyé:sgó:ɂi	He usually is eating flexible things
ᏕᏥᏟᏏᎭ	de:jíhli:síha	I am gathering things
ᎢᏥᎷᎦ	ì:ji:lù:ga	Let you all climb it
ᎡᎦᎦᏙᏍᏓ	è:gagà:tǒ:sda	Let all of us be looked at
ᎤᏓᎦᏙᏍᏔᏅᎢ	ù:dà:ktǒ:stánv̌:ɂi	He looked at himself a while ago
ᎡᎾᎦᏙᏍᏓ	è:nagà:tǒ:sda	Let you (1) and me look at him
ᏣᏓᎦᏙᏍᏔᏅᎢ	jadà:ktǒ:stánv̌:ɂi	You (1) looked at yourself a while ago
ᏕᏥᏁᎭ	dé:ji:néha	You all have liquid things
ᎠᏍᏗᎦ	asdǐ:gā	He recently ate something rod shaped
ᎡᏣᎧᎮᏍᏗ	è:jakahé:sdi	Someone will have you (1)
ᏗᏍᏗᏍᏗᎩᏍᏗ	disdi:sdǐ:gî:sdi	For you both to eat rod shaped things
ᎡᏓᎦᏙᏍᏓ	è:dagà:tǒ:sda	Let all of us look at him
ᎠᏆᏓᎦᏙᏍᏔᏅᎢ	à:gwadà:ktǒ:stánv̌:ɂi	I looked at myself a while ago
ᏥᏍᏗᎦ	jisdǐ:gā	I recently ate something rod shaped
ᎡᏣᎦᏙᏍᏓ	è:jagà:tǒ:sda	Let you all look at him; Let you all be looked at
ᎯᏯᎦᏙᏍᏓ	hi:yagà:tǒ:sda	Let you (1) look at him
ᎡᏍᏓᎦᏙᏍᏓ	è:sdagà:tǒ:sda	Let you both look at him; Let you both be looked at
ᎡᎩᎾᎦᏙᏍᏓ	è:ginagà:tǒ:sda	Let you (1) and me be looked at
ᏣᏰᏍᏗ	jahyè:sdi	For you (1) to eat something flexible
ᎢᏍᎩᏯᎦᏙᏍᏓ	ì:sgi:yagà:tǒ:sda	Let you (1), two, or all look at us all; Let you all look at me
ᎨᏍᏓᎦᏙᏍᏓ	ge:sdagà:tǒ:sdā	You both recently looked at them (animate); They recently looked at you both
ᎦᎯᏯᎦᏙᏍᏓ	gahi:yagà:tǒ:sda	Let you (1) look at them (animate)
ᎢᏨᏯᎦᏙᏍᏓ	ì:jv:yagà:tǒ:sdā	I, we two, or we all recently looked at you all; We all recently looked at you (1), two
ᏕᎪᎩᏂᎧᎲᎢ	de:go:gini:kahv̌:ɂi	They had him and me a while ago
ᏓᏉᎵᏨᎢ	dà:gwohljv̌:ɂi	I understood things a while ago
ᏕᏦᎵᏨᎢ	de:johljv̌:ɂi	You (1) understood things a while ago
ᎬᏯᏚᎵᎭ	gv:yadu:líha	I am wanting you (1)
ᏥᏯᏚᎵᎭ	ji:yadu:líha	I am wanting him
ᎦᏥᏯᏚᎵᎭ	gaji:yadu:líha	I am wanting them (animate)
ᎠᏉᎵᎦ	à:gwohlga	He recognizes me
ᎣᎩᎪᎲᎢ	ò:gi:go:hv̌:ɂi	He saw them and me a while ago; They and I saw it a while ago; They and I were seen a while ago
ᎤᏂᎪᎲᎢ	ù:ni:go:hv̌:ɂi	They saw him a while ago; They saw it a while ago
ᎣᎩᏂᎪᎲᎢ	ò:gini:go:hv̌:ɂi	He saw him and me a while ago; He and I saw it a while ago; He and I were seen a while ago
ᏂᎯ	nihi	You one; You two; You all
ᏣᏲᏏᏌ	jayò:sǐ:sa	Let you (1) be hungry
ᏚᏍᏗᎬᎢ	dù:sdí:gv̌:ɂi	He ate rod shaped things a while ago
ᏥᏯᎦ	jiyagā	I recently ate something flexible
ᏕᎦᏗᏔᏍᎪᎢ	de:gà:di:tasgó:ɂi	I am usually drinking drinks
ᏓᏂᎭᏗᏔ	dà:na:dǐ:tā	They recently drank drinks
ᏕᎩᏂᎾᎥᎢ	de:gini:náv̌:ɂi	You (1) and I had flexible things a while ago
ᏕᏂᎭᏗᏔ	dé:na:dǐ:tā	You (1) and I recently drank drinks
ᏙᎩᏂᎾᎥᎢ	dò:gini:náv̌:ɂi	He and I had flexible things a while ago
ᏕᏗᎭᏗᏔ	dé:da:dǐ:tā	All of us recently drank drinks
ᏙᏥᎭᏗᏔ	dò:ja:dǐ:tā	They and I recently drank drinks
ᏕᎦᏟᏏᎭ	de:gáhli:síha	He is gathering things
ᏙᏍᏗᎭᏗᏔ	dò:sda:dǐ:tā	He and I recently drank drinks
ᎤᏩᏌ	uwa̋:sa	He alone
ᏗᏍᏗᎭᏗᏔ	disda:dǐ:ta	Let you both drink drinks
ᎢᏂᏍᏗᎦ	ì:ni:sdǐ:ga	Let you (1) and me eat something rod shaped
ᎤᏂᎮᏍᏗ	ù:ni:hé:sdi	They will be having something solid
ᎢᏗᏍᏗᎦ	ì:di:sdǐ:ga	Let all of us eat something rod shaped
ᏕᏥᏍᏗᎦ	dé:ji:sdǐ:gā	You all recently ate rod shaped things
ᎩᏂᎮᏍᏗ	gini:hé:sdi	You (1) and I will be having something solid
ᏕᏍᏗᏍᏗᎦ	de:sdi:sdǐ:gā	You both recently ate rod shaped things
ᏣᎪᏩᏘᏍᎪᎢ	jagowhtǐ:sgóɂi	He is often seeing you (1)
ᏕᎨᏥᎧᎰᎢ	de:gé:ji:kahó:ɂi	They usually have you all
ᏕᎪᏥᎧᎰᎢ	de:go:ji:kahó:ɂi	They and I usually have living things
ᏕᎪᏍᏗᎧᎰᎢ	de:go:sdi:kahó:ɂi	He and I usually have living things
ᎰᎵᎩ	hohlgi	Let you (1) understand it
ᎬᏯᏚᎸᎲᎢ	gv:yadu:lv:hv̌:ɂi	I wanted you (1) a while ago
ᏥᏯᏚᎸᎲᎢ	ji:yadu:lv:hv̌:ɂi	I wanted him a while ago
ᎦᏥᏯᏚᎸᎲᎢ	gaji:yadu:lv:hv̌:ɂi	I wanted them (animate) a while ago
ᎠᏉᎵᎦ	à:gwohlgā	He recently recognized me
ᎢᏨᏯᏚᎵᎭ	ì:jv:yadu:líha	I, we two, or we all are wanting you all; We all are wanting you (1), two
ᎢᎩᎪᎲᎢ	ì:gi:go:hv̌:ɂi	He saw all of us a while ago; All of us saw it a while ago
ᎣᎩᎪᏩᏔ	ò:gi:gò:wahtā	He recently saw them and me; They and I were recently seen
ᏍᏗᏥ	sdi:ji	Your two's mother
ᎠᏂᎴᎪᎢ	à:ní:lè:gó:ɂi	They usually are climbing it
ᏕᎦᏚᎩᏍᎪᎢ	de:gaɂdǔ:gî:sgó:ɂi	I am usually drinking alcoholic drinks
ᏣᏲᏏᏌ	jayò:sǐ:sā	You (1) were recently hungry
ᎤᏂᎸᏒᎢ	ù:ni:lv̂:sv̌:ɂi	They climbed it a while ago
ᏚᏅᏔ	du:nhta	He knows things
ᎩᏂᎸᏒᎢ	gini:lv̂:sv̌:ɂi	You (1) and I climbed it a while ago
ᏕᎩᏂᏁᎮᏍᏗ	de:gini:ne:hé:sdi	You (1) and I will be having liquid things
ᏙᎩᏂᏁᎮᏍᏗ	dò:gini:ne:hé:sdi	He and I will be having liquid things
ᎣᏤᎪᎢ	ò:jé:góɂi	They and I usually are going
ᏓᎩᎾᎣᎢ	dà:gináó:ɂi	I usually have flexible things
ᏕᎦᏚᎩᎠ	de:gàtǔ:gía	He is drinking alcoholic drinks
ᎣᏍᏕᎪᎢ	ò:sdé:góɂi	He and I usually are going
ᏕᏣᎾᎣᎢ	de:janáó:ɂi	You (1) usually have flexible things
ᏕᏥᏯᎥᎢ	dé:ji:hyá:ɂv̌:ɂi	You all ate flexible things a while ago
ᏕᏍᏗᏯᎥᎢ	de:sdi:hyá:ɂv̌:ɂi	You both ate flexible things a while ago
ᏗᏍᏚᏗᏔᏍᏗ	disda:di:tasdi	For you both to drink drinks
ᎣᎩᎮᏍᏗ	ò:gi:hé:sdi	They and I will be having something solid
ᎣᎩᏂᎮᏍᏗ	ò:gini:hé:sdi	He and I will be having something solid
ᏕᏍᏓᏓᎧᎰᎢ	de:sdada:kahó:ɂi	You both usually have each other
ᎢᏨᏯᏚᎸᎲᎢ	ì:jv:yadu:lv:hv̌:ɂi	I, we two, or we all wanted you all a while ago; We all wanted you (1), two a while ago
ᎯᏯᏚᎵᎭ	hi:yadu:líha	You (1) are wanting him
ᎢᏍᎩᏯᏚᎵᎭ	ì:sgi:yadu:líha	You (1), two, or all are wanting us all; You all are wanting me
ᎦᎯᏯᏚᎵᎭ	gahi:yadu:líha	You (1) are wanting them (animate)
ᎯᎪᏩᏔ	higò:wahta	Let you (1) see it
ᎢᎩᎪᏩᏔ	ì:gi:gò:wahtā	He recently saw all of us
ᏍᏛᏥ	sdv:ji	I, your two's mother
ᎤᏂᎸᏍᏗ	ù:ni:lv̀:sdi	For them to climb it
ᎦᎴᎪᎢ	gálè:gó:ɂi	He usually is climbing it
ᏕᎩᏍᏗᎬᎢ	dé:gì:sdí:gv̌:ɂi	All of us ate rod shaped things a while ago
ᎩᏂᎸᏍᏗ	gini:lv̀:sdi	For you (1) and me to climb it
ᏥᎴᎪᎢ	jílè:gó:ɂi	I am usually climbing it
ᏙᎩᏍᏗᎬᎢ	dò:gì:sdí:gv̌:ɂi	They and I ate rod shaped things a while ago
ᎣᎩᎸᏒᎢ	ò:gi:lv̂:sv̌:ɂi	They and I climbed it a while ago
ᏚᏂᏍᏗᎬᎢ	dù:nì:sdí:gv̌:ɂi	They ate rod shaped things a while ago
ᎣᎩᏂᎸᏒᎢ	ò:gini:lv̂:sv̌:ɂi	He and I climbed it a while ago
ᏕᎩᏂᏍᏗᎬᎢ	de:ginì:sdí:gv̌:ɂi	You (1) and I ate rod shaped things a while ago
ᏙᎩᏂᏍᏗᎬᎢ	dò:ginì:sdí:gv̌:ɂi	He and I ate rod shaped things a while ago
ᏕᏥᏚᎲᏍᎦ	de:jídu:hv́sga	I am baking things
ᎢᎩᎮᏍᏗ	ì:gi:hé:sdi	All of us will be having something solid
ᏓᎪᏩᏘᎭ	dagowhtíha	He is seeing them
ᏗᏍᏓᎦᏙᏍᏓ	disdaktǒ:sda	Let you both look at them (inanimate)
ᎡᏣᎪᏩᏘᎭ	è:jagowhtíha	You (1) are being seen
ᎨᏣᎪᏩᏘᎭ	ge:jagowhtíha	They are seeing you (1)
ᏕᏍᏓᏓᎧᎲᎢ	de:sdada:kahv̌:ɂi	You both had each other a while ago
ᏩᏉᎵᎩ	wà:gwohlgi	Let him recognize me
ᎠᏃᎵᎦ	à:nohlga	They understand it; They recognize him
ᎦᎯᏯᏚᎸᎲᎢ	gahi:yadu:lv:hv̌:ɂi	You (1) wanted them (animate) a while ago
ᏣᎪᎲᎢ	jago:hv̌:ɂi	You (1) saw it a while ago; He saw you (1) a while ago
ᎣᏥᎪᎲᎢ	ò:ji:go:hv̌:ɂi	They and I saw him a while ago
ᎣᏍᏗᎪᎲᎢ	ò:sdi:go:hv̌:ɂi	He and I saw him a while ago
ᏣᏥ	jaji	xShe, your one's mother
ᎤᏲᏏᎭ	ù:yó:siha	He is hungry
ᏍᏛᏯᎦᏙᏍᏙᏗ	sdv:yagà:tǒ:sdóhdi	For me to look at you both; For we two to look at you (1) or you both
ᏕᎾᏚᎩᏍᎪᎢ	dé:nà:tǔ:gî:sgó:ɂi	You (1) and I usually are drinking alcoholic drinks
ᎣᎩᎸᏍᏗ	ò:gi:lv̀:sdi	For them and me to climb it
ᎣᎩᏂᎸᏍᏗ	ò:gini:lv̀:sdi	For him and me to climb it
ᎢᎩᎸᏒᎢ	ì:gi:lv̂:sv̌:ɂi	All of us climbed it a while ago
ᏙᏍᏓᏚᎩᏍᎪᎢ	dò:sdà:tǔ:gî:sgó:ɂi	He and I usually are drinking alcoholic drinks
ᏕᏥᏚᏅᎢ	dé:jí:du:hnv̌:ɂi	You all baked things a while ago
ᏕᏥᏍᏗᎩᎠ	de:jìsdǐ:gíɂa	I am eating rod shaped things
ᏕᏍᏗᏚᏅᎢ	de:sdí:du:hnv̌:ɂi	You both baked things a while ago
ꮪꮹᏚᏅᎢ	du:wá:du:hnv̌:ɂi	He baked things a while ago
ᎤᏂᎾᎠ	ù:ni:náɂa	They have something flexible
ᎯᏍᏗᎦ	hisdǐ:ga	Let you (1) eat something rod shaped
ᏕᎬᎩᎧᎮᏍᏗ	de:gv:gikahé:sdi	They will be having me
ᎡᏣᎦᏙᏍᏔᏅᎢ	è:jà:ktǒ:stánv̌:ɂi	You (1) were looked at a while ago
ᏣᎮᏍᏗ	jahé:sdi	You (1) will be having something solid
ᎠᎩᏰᏍᏗ	à:gihyè:sdi	For me to eat something flexible
ᎨᏣᎦᏙᏍᏔᏅᎢ	ge:jà:ktǒ:stánv̌:ɂi	They looked at you (1) a while ago
ᏕᎪᎵᏨᎢ	dé:gohljv̌:ɂi	All of us understood things a while ago
ᏙᎪᎵᏨᎢ	dò:gohljv̌:ɂi	They and I understood things a while ago
ᏚᏃᎵᏨᎢ	dù:nohljv̌:ɂi	They understood things a while ago; They recognized them (animate) a while ago
ᏕᎩᏃᎵᏨᎢ	de:ginohljv̌:ɂi	You (1) and I understood things a while ago
ᏙᎩᏃᎵᏨᎢ	dò:ginohljv̌:ɂi	He and I understood things a while ago
ᏕᎨᏂᎧᎰᎢ	de:ge:ni:kahó:ɂi	You (1) and I usually have living things
ᏕᎨᏗᎧᎰᎢ	de:ge:di:kahó:ɂi	All of us usually have living things
ᏕᎨᏥᎧᎰᎢ	de:ge:ji:kahó:ɂi	You all usually have living things; Someone often has them
ᏕꮸꮿᎧᎰᎢ	dé:jv:ya:kahó:ɂi	I, we two, or we all usually have you all; We all usually have you (1), two
ᏥᏙᏓ	ji:do:da	I, his father
ᎠᎩᏲᏏᏌ	à:giyò:sǐ:sā	I was recently hungry
ᎠᎦᎦᏙᏍᏙᏗ	à:gagà:tǒ:sdóhdi	For him to be looked at
ᏕᎦᎦᏙᏍᏗᏍᎪᎢ	de:gà:gà:tǒ:sdí:sgó:ɂi	I am often looking at them (inanimate)
ᎢᎩᎸᏍᏗ	ì:gi:lv̀:sdi	For all of us to climb it
ᏣᎸᏒᎢ	jalv̂:sv̌:ɂi	You (1) climbed it a while ago
ᏓᎩᏍᏗᎬᎢ	dà:gìsdí:gv̌:ɂi	I ate rod shaped things a while ago
ᏗᏥᏁᏗ	dì:ji:nehdi	For you all to have a liquid
ᏍᏓᏗᎭ	sdadiha	You both are saying
ᏕᎦᏚᎲᏍᎦ	de:gádu:hv́sga	He is baking things
ᎤᎥᏰᏍᏗ	ù:jv̌:yê:sdi	He will be having something rod shaped
ᎤᏂᏁᎰᎢ	ù:ni:ne:hó:ɂi	They usually have a liquid
ᎣᎩᎾᎠ	ò:gi:náɂa	They and I have something flexible
ᎣᎩᏂᎾᎠ	ò:gini:náɂa	He and I have something flexible
ᎯᏍᏗᎦ	hisdǐ:gā	You (1) recently ate something rod shaped
ᎡᏣᎦᏙᏍᏗᏍᎪᎢ	è:jà:ktǒ:sdí:sgó:ɂi	You (1) are often looked at
ᎣᏥᏍᏗᎦ	ò:ji:sdǐ:gā	They and I recently ate something rod shaped
ᎣᏍᏗᏍᏗᎦ	ò:sdi:sdǐ:gā	He and I recently ate something rod shaped
ᎨᎩᎪᏩᏘᎭ	ge:gi:gowhtíha	They are seeing all of us
ᏕᎯᎪᏩᏘᎭ	de:higowhtíha	You (1) are seeing them (inanimate)
ᏕꮸꮿᎧᎲᎢ	dé:jv:ya:kahv̌:ɂi	I, we two, or we all had you all a while ago; We all had you (1), two a while ago
ᏕᎨᏍᏗᎧᎰᎢ	de:ge:sdi:kahó:ɂi	You both usually have living things; They usually have you both
ᏕꮝꮫꮿᎧᎰᎢ	de:sdv:ya:kahó:ɂi	I usually have you both; We two usually have you (1) or you both
ᎠᎵᎢ	a:liɂi	Friendship
ᏕᎯᏚᎲᏍᎪᎢ	de:hídu:hvsgó:ɂi	You (1) are usually baking things
ᏣᎸᏍᏗ	jalv̀:sdi	For you (1) to climb it
ᎨᎾᎦᏙᏍᏙᏗ	ge:nagà:tǒ:sdóhdi	For you (1) and me to look at them (animate)
ᎨᏓᎦᏙᏍᏙᏗ	ge:dagà:tǒ:sdóhdi	For all of us to look at them (animate)
ᎤᎾᎣᎢ	ù:náó:ɂi	He usually has something flexible
ᎦᏗᏔᏍᎦ	gà:di:tásga	I am drinking something
ᎨᏣᎦᏙᏍᏙᏗ	ge:jagà:tǒ:sdóhdi	For you all to look at them (animate)
ᎬᏯᎦᏙᏍᏙᏗ	gv:yagà:tǒ:sdóhdi	For me to look at you (1)
ᏥᏯᎦᏙᏍᏙᏗ	ji:yagà:tǒ:sdóhdi	For me to look at him
ᎦᏥᏯᎦᏙᏍᏙᏗ	gaji:yagà:tǒ:sdóhdi	For me to look at them (animate)
ᎣᎩᏁᎰᎢ	ò:gi:ne:hó:ɂi	They and I usually have a liquid
ᎣᎩᏂᏁᎰᎢ	ò:gini:ne:hó:ɂi	He and I usually have a liquid
ᎢᎩᎾᎠ	ì:gi:náɂa	All of us have something flexible
ᎡᏣᎪᏩᏘᏍᎪᎢ	è:jagowhtǐ:sgóɂi	You (1) are usually seen
ᏫᏨᏯᎦᏙᏍᏓ	wì:jv:yagà:tǒ:sda	Let us, me, two, or we all look at you all; Let us all look at you (1), two
ᎠᏥᎧᎮᏍᏗ	à:jikahé:sdi	Someone will have him
ᏕᏦᎵᎦ	dé:johlga	You all understand things
ᏕᏍᏙᎵᎦ	de:sdohlga	You both understand things
ᏕꮝꮫꮿᎧᎲᎢ	de:sdv:ya:kahv̌:ɂi	I had you both a while ago; We two had you (1) or you both a while ago
ᏕᏥᎪᏩᏘᎭ	de:jigowhtíha	I am seeing them (inanimate)
ᎢᎩᏙᏓ	ì:gi:do:da	Your all's and my father
ᏕᎦᏚᎩᏒᎢ	dé:gàtǔ:gî:sv̌:ɂi	All of us drank alcoholic drinks a while ago
ᏙᎦᏚᎩᏒᎢ	dò:gàtǔ:gî:sv̌:ɂi	They and I drank alcoholic drinks a while ago
ᏚᎾᏚᎩᏒᎢ	dù:nàtǔ:gî:sv̌:ɂi	They drank alcoholic drinks a while ago
ᏕᎩᎾᏚᎩᏒᎢ	de:ginàtǔ:gî:sv̌:ɂi	You (1) and I drank alcoholic drinks a while ago
ᏕᎯᏟᏏᏍᎪᎢ	de:híhli:sǐ:sgóɂi	You (1) are usually gathering things
ᏙᎩᎾᏚᎩᏒᎢ	dò:ginàtǔ:gî:sv̌:ɂi	He and I drank alcoholic drinks a while ago
ᏕᏥᏚᎲᏍᎪᎢ	de:jídu:hvsgó:ɂi	I am usually baking things
ᏕᏣᏍᏗᎬᎢ	de:jàsdí:gv̌:ɂi	You (1) ate rod shaped things a while ago
ᎢᏣᏗᎭ	ì:jadiha	You all are saying
ᎤᎾᎥᎢ	ù:náv̌:ɂi	He had something flexible a while ago
ᎢᎩᏁᎰᎢ	ì:gi:ne:hó:ɂi	All of us usually have a liquid
ᎯᏯᎦᏙᏍᏙᏗ	hi:yagà:tǒ:sdóhdi	For you (1) to look at him
ᎨᏣᎪᏩᏘᏍᎪᎢ	ge:jagowhtǐ:sgóɂi	They are often seeing you (1)
ᎢᏍᎩᏯᎦᏙᏍᏙᏗ	ì:sgi:yagà:tǒ:sdóhdi	For you (1), two, or all to look at us all; For you all to look at me
ᎦᎯᏯᎦᏙᏍᏙᏗ	gahi:yagà:tǒ:sdóhdi	For you (1) to look at them (animate)
ᎦᎦᏙᏍᏓ	gagà:tǒ:sdā	I recently looked at it
ꭼꮿᎧᎮᏍᏗ	gv:ya:kahé:sdi	I will be having you (1)
ᏚᏬᎵᏨᎢ	du:wohljv̌:ɂi	He understood things a while ago; He recognized them (animate) a while ago
ᏍᎩᎪᏩᏘᎭ	sgigowhtíha	You (1) are seeing me
ᎥᎩᎪᏩᏘᎭ	v̀:gigowhtíha	I am being seen
ᎠᎩᎪᎲᎢ	à:gigo:hv̌:ɂi	I saw it a while ago; He saw me a while ago
ᎢᏍᎩᏥ	ì:sgi:ji	You one, their and my mother
ᎦᏗᏍᎪᎢ	gadǐ:sgó:ɂi	I am often saying
ᎠᎦᎦᏙᏍᏔᏅᎢ	à:gà:gà:tǒ:stánv̌:ɂi	He was looked at a while ago
ᏕᏂᏍᏗᎩᏍᎪᎢ	dé:nì:sdǐ:gî:sgó:ɂi	You (1) and I usually are eating rod shaped things
ᎨᏣᎦᏙᏍᏔᏅᎢ	gé:jà:gà:tǒ:stánv̌:ɂi	They looked at you all a while ago
ᎪᏣᎦᏙᏍᏔᏅᎢ	go:jà:gà:tǒ:stánv̌:ɂi	They and I looked at them (animate) a while ago
ᎪᏍᏓᎦᏙᏍᏔᏅᎢ	go:sdà:gà:tǒ:stánv̌:ɂi	He and I looked at them (animate) a while ago
ᏕᎯᏍᏗᎩᏍᎪᎢ	de:hìsdǐ:gî:sgó:ɂi	You (1) usually are eating rod shaped things
ᏍᏛᏯᎦᏙᏍᏔᏅᎢ	sdv:yà:gà:tǒ:stánv̌:ɂi	I looked at you both a while ago; We two looked at you (1) or you both a while ago
ᏕᏥᏟᏏᏍᎪᎢ	de:jíhli:sǐ:sgóɂi	I am usually gathering things
ᏙᏍᏗᏍᏗᎩᏍᎪᎢ	dò:sdì:sdǐ:gî:sgó:ɂi	He and I usually are eating rod shaped things
ᏕᏥᏰᏍᎪᎢ	dé:ji:hyé:sgó:ɂi	You all usually are eating flexible things
ᎤᏂᏯᎥᎢ	ù:ni:hyá:ɂv̌:ɂi	They ate something flexible a while ago
ᎩᏂᏯᎥᎢ	gini:hyá:ɂv̌:ɂi	You (1) and I ate something flexible a while ago
ᎢᎩᏁᎲᎢ	ì:gi:ne:hv̌:ɂi	All of us had a liquid a while ago
ᏣᏁᎰᎢ	jane:hó:ɂi	You (1) usually have a liquid
ᎦᏥᎪᏩᏘᏍᎪᎢ	gaji:gowhtǐ:sgóɂi	I am often seeing them (animate)
ꭿꮿᎧᎮᏍᏗ	hi:ya:kahé:sdi	You (1) will be having something alive
ꭶꭿꮿᎧᎮᏍᏗ	gahi:ya:kahé:sdi	You (1) will be having living things
ᏕꮝꭹꮿᎧᎮᏍᏗ	dé:sgi:ya:kahé:sdi	You (1), two, or all will be having us all; You all will be having me
ᏕᏍᎩᏂᎧᎭ	de:sgini:káha	You (1) or both have us both
ᎢᏥᏙᏓ	ì:ji:do:da	Your all's father
ᏕᎩᏟᏌᏅᎢ	dé:gí:hli:sahnv̌:ɂi	All of us gathered things a while ago
ᏓᏊᏗᏔᎲᎢ	dà:gwù:di:tahv̌:ɂi	I drank drinks a while ago
ᎦᏚᎩᎠ	gaɂdǔ:gía	I am drinking something alcoholic
ᏙᎩᏟᏌᏅᎢ	dò:gí:hli:sahnv̌:ɂi	They and I gathered things a while ago
ᏕᏧᏗᏔᎲᎢ	de:jù:di:tahv̌:ɂi	You (1) drank drinks a while ago
ᏕᎩᏂᏟᏌᏅᎢ	de:giní:hli:sahnv̌:ɂi	You (1) and I gathered things a while ago
ᏙᎩᏂᏟᏌᏅᎢ	dò:giní:hli:sahnv̌:ɂi	He and I gathered things a while ago
ᎡᎦᎦᏙᏍᏔᏅᎢ	è:gà:gà:tǒ:stánv̌:ɂi	All of us were looked at a while ago
ᎡᎾᎦᏙᏍᏔᏅᎢ	è:nà:gà:tǒ:stánv̌:ɂi	You (1) and I looked at him a while ago
ᎤᏍᏗᎬᎢ	ù:sdí:gv̌:ɂi	He ate something rod shaped a while ago
ᎡᏓᎦᏙᏍᏔᏅᎢ	è:dà:gà:tǒ:stánv̌:ɂi	All of us looked at him a while ago
ᎡᏣᎦᏙᏍᏔᏅᎢ	è:jà:gà:tǒ:stánv̌:ɂi	You all looked at him a while ago; You all were looked at a while ago
ᎤᏂᏚᏅᎢ	ù:ní:du:hnv̌:ɂi	They baked something a while ago
ᎣᎩᏯᎥᎢ	ò:gi:hyá:ɂv̌:ɂi	They and I ate something flexible a while ago
ᎣᎩᏂᏯᎥᎢ	ò:gini:hyá:ɂv̌:ɂi	He and I ate something flexible a while ago
ᎡᏍᏓᎦᏙᏍᏔᏅᎢ	è:sdà:gà:tǒ:stánv̌:ɂi	You both looked at him a while ago; You both were looked at a while ago
ᎡᎩᎾᎦᏙᏍᏔᏅᎢ	è:ginà:gà:tǒ:stánv̌:ɂi	You (1) and I were looked at a while ago
ᎠᎩᎮᏍᏗ	à:gihé:sdi	I will be having something solid
ᎥᏆᏚᎵᏍᎪᎢ	v̀:gwadu:lǐ:sgóɂi	I am often wanted
ᎯᎪᏩᏘᏍᎪᎢ	hi:gowhtǐ:sgóɂi	You (1) are often seeing him
ᏍᏓᏓᏚᎵᏍᎪᎢ	sdadadu:lǐ:sgóɂi	You both usually are wanting yourselves
ᎢᏣᏓᏚᎵᏍᎪᎢ	ì:jadadu:lǐ:sgóɂi	You all usually are wanting yourselves
ᎢᏍᎩᎪᏩᏘᏍᎪᎢ	ì:sgi:gowhtǐ:sgóɂi	You (1), two, or all are often seeing us all; You all are often seeing me
ᎦᎯᎪᏩᏘᏍᎪᎢ	gahi:gowhtǐ:sgóɂi	You (1) are often seeing them (animate)
ᎢᏨᏙᏓ	ì:jv:do:da	I, your all's father
ᏕᎫᏗᏔᎲᎢ	dé:gù:di:tahv̌:ɂi	All of us drank drinks a while ago
ᏙᎫᏗᏔᎲᎢ	dò:gù:di:tahv̌:ɂi	They and I drank drinks a while ago
ᏚᏄᏗᏔᎲᎢ	dù:nù:di:tahv̌:ɂi	They drank drinks a while ago
ᏕᎩᏄᏗᏔᎲᎢ	de:ginù:di:tahv̌:ɂi	You (1) and I drank drinks a while ago
ᏙᎩᏄᏗᏔᎲᎢ	dò:ginù:di:tahv̌:ɂi	He and I drank drinks a while ago
ᎠᎩᎸᏒᎢ	à:gilv̂:sv̌:ɂi	I climbed it a while ago
ᏍᏕᏅᏒᎢ	sde:nv́:sv̌:ɂi	You both went a while ago
ᎦᎭᏗᏔ	ga:dǐ:tā	I recently drank something
ᏕᏥᎾᎣᎢ	dé:ji:náó:ɂi	You all usually have flexible things
ᎡᎾᎦᏙᏍᏗᏍᎪᎢ	è:nà:gà:tǒ:sdí:sgó:ɂi	You (1) and I are often looking at him
ᎢᎩᏯᎥᎢ	ì:gi:hyá:ɂv̌:ɂi	All of us ate something flexible a while ago
ᎯᏯᎦᏙᏍᏔᏅᎢ	hi:yà:gà:tǒ:stánv̌:ɂi	You (1) looked at him a while ago
ᎣᏦᎵᏍᏗ	ò:jo:lí:sdi	For them and me to recognize him
ᎣᏍᏙᎵᏍᏗ	ò:sdo:lí:sdi	For him and me to recognize him
ᏓᏂᎪᏩᏘᏍᎪᎢ	dà:ni:gowhtǐ:sgóɂi	They are often seeing them
ᏕᏂᎪᏩᏘᏍᎪᎢ	dé:ni:gowhtǐ:sgóɂi	You (1) and I are often seeing them (inanimate)
ᏕᏗᎪᏩᏘᏍᎪᎢ	dé:di:gowhtǐ:sgóɂi	All of us are often seeing them (inanimate)
ᏙᏥᎪᏩᏘᏍᎪᎢ	dò:ji:gowhtǐ:sgóɂi	They and I are often seeing them (inanimate)
ᏕᎯᎪᏩᏘᏍᎪᎢ	de:higowhtǐ:sgóɂi	You (1) are often seeing them (inanimate)
ᏕᏥᎪᏩᏘᏍᎪᎢ	de:jigowhtǐ:sgóɂi	I am often seeing them (inanimate)
ᏙᏍᏗᎪᏩᏘᏍᎪᎢ	dò:sdi:gowhtǐ:sgóɂi	He and I are often seeing them (inanimate)
ᎢᏃᎵᎩ	ì:nohlgi	Let you (1) and me understand it
ᎤᏃᎵᏍᏗ	ù:no:hlísdi	For them to understand it; For them to recognize him
ᎢᏙᎵᎩ	ì:dohlgi	Let all of us understand it
ᎩᏃᎵᏍᏗ	gino:hlísdi	For you (1) and me to understand it; For him to recognize you (1) and me
ᎣᎩᏙᏓ	o:gi:do:da	Their and my father
ᏕᏣᏅᏖᏍᏗ	de:janhté:sdi	You (1) will be knowing things
ᏥᏰᏍᎪᎢ	jiyé:sgó:ɂi	I am usually eating something flexible
ᏚᏂᏲᏏᏌ	dù:ni:yò:sǐ:sā	They were recently hungry
ᎠᎩᎸᏍᏗ	à:gilv̀:sdi	For me to climb it
ᏍᏕᏅᏍᏗ	sde:nv̀:sdi	For you both to go
ᎣᏦᎵᏨᎢ	ò:jo:li:jv̌:ɂi	They and I recognized him a while ago
ᎢᏣᏓᎦᏙᏍᏔᏅᎢ	ì:jadà:ktǒ:stánv̌:ɂi	You all looked at yourselves a while ago
ᎣᏍᏙᎵᏨᎢ	ò:sdo:li:jv̌:ɂi	He and I recognized him a while ago
ᎡᎦᏚᎵᏍᎪᎢ	è:gadu:lǐ:sgóɂi	All of us are often wanted
ᎡᎾᏚᎵᏍᎪᎢ	è:nadu:lǐ:sgóɂi	You (1) and I usually are wanting him
ᎡᏓᏚᎵᏍᎪᎢ	è:dadu:lǐ:sgóɂi	All of us usually are wanting him
ᎡᏣᏚᎵᏍᎪᎢ	è:jadu:lǐ:sgóɂi	You all usually are wanting him; You (1) are often wanted; You all are often wanted
ᏙᎦᏚᎵᏍᎪᎢ	dò:gadu:lǐ:sgóɂi	They and I usually are wanting them (inanimate)
ᎣᎪᎵᏍᏗ	ò:go:hlísdi	For them and me to understand it; For him to recognize them and me; For them and me to be recognized
ᎣᎩᏃᎵᏍᏗ	ò:gino:hlísdi	For him and me to understand it; For him to recognize him and me; For him and me to be recognized
ᎡᎩᎾᏚᎵᏍᎪᎢ	è:ginadu:lǐ:sgóɂi	You (1) and I are often wanted
ᎤᏂᏙᏓ	u:ni:do:da	Their father
ᏣᏛᏅᎢ	jadv:hnv̌:ɂi	You (1) said a while ago
ᏥᎠᏗᎠ	jigà:taha	I know how
ᏓᏆᏅᏖᏍᏗ	dà:gwanhté:sdi	I will be knowing things
ᎢᏤᏅᏒᎢ	ì:je:nv́:sv̌:ɂi	You all went a while ago
ᎤᏪᏅᏒᎢ	ù:we:nv́:sv̌:ɂi	He went a while ago
ᎠᎭᏗᏔ	a:dǐ:tā	He recently drank something
ᎠᎩᎾᎠ	à:gináɂa	I have something flexible
ᏍᎩᎾᎦᏙᏍᏓ	sginagà:tǒ:sda	Let you (1) or both look at us both
ᏕᎦᎦᏙᏍᏔᏅᎢ	dé:gà:ktǒ:stánv̌:ɂi	All of us looked at them (inanimate) a while ago
ᏙᎦᎦᏙᏍᏔᏅᎢ	dò:gà:ktǒ:stánv̌:ɂi	They and I looked at them (inanimate) a while ago
ᏚᎾᎦᏙᏍᏔᏅᎢ	dù:nà:ktǒ:stánv̌:ɂi	They looked at them a while ago
ᏕᎩᎾᎦᏙᏍᏔᏅᎢ	de:ginà:ktǒ:stánv̌:ɂi	You (1) and I looked at them (inanimate) a while ago
ᏙᎩᎾᎦᏙᏍᏔᏅᎢ	dò:ginà:ktǒ:stánv̌:ɂi	He and I looked at them (inanimate) a while ago
ᎢᎪᎵᏍᏗ	ì:go:hlísdi	For all of us to understand it; For him to recognize all of us
ᎣᏦᎵᎦ	ò:johlga	They and I understand it
ᎣᏍᏙᎵᎦ	ò:sdohlga	He and I understand it
ᎠᏥᎪᏩᏘᏍᎪᎢ	à:jigowhtǐ:sgóɂi	He is usually seen
ᎦᎯᏙᏓ	gahi:do:da	You one, their father
ᏓᏆᏅᏙɂᎢ	dà:gwanhtó:ɂi	I usually know things
ᎩᎾᏛᏅᎢ	ginadv:hnv̌:ɂi	You (1) and I said a while ago
ᏚᏭᏗᏔᎲᎢ	du:wù:di:tahv̌:ɂi	He drank drinks a while ago
ᎢᏤᏅᏍᏗ	ì:je:nv̀:sdi	For you all to go
ᎤᏪᏅᏍᏗ	ù:we:nv̀:sdi	For him to go
ᎠᎩᏁᎰᎢ	à:gine:hó:ɂi	I usually have a liquid
ᎦᏥᏥ	gaji:ji	I, their mother
ᎩᎾᏘᏗ	ginatdi	For you (1) and me to say it
ᏫᎦᏚᎩ	wigaɂdǔ:gi	Let me drink something alcoholic
ᏓᏆᏅᏛɂᎢ	dà:gwanhtv̌:ɂi	I knew things a while ago
ᏚᏅᏖᏍᏗ	du:nhté:sdi	He will be knowing things
ᎤᎾᏛᏅᎢ	ù:nadv:hnv̌:ɂi	They said a while ago
ᎭᏗᏍᎪᎢ	hadǐ:sgó:ɂi	You (1) are often saying
ᏙᎩᏲᏏᏌ	dò:gi:yò:sǐ:sā	They and I were recently hungry
ᏙᎩᏂᏲᏏᏌ	dò:gini:yò:sǐ:sā	He and I were recently hungry
ᏕᏥᏍᏗᎬᎢ	dé:jì:sdí:gv̌:ɂi	You all ate rod shaped things a while ago
ᏕᏍᏗᏍᏗᎬᎢ	de:sdì:sdí:gv̌:ɂi	You both ate rod shaped things a while ago
ᎠᏃᎵᎪᎢ	à:nohlgó:ɂi	They usually understand it; They usually recognize him
ᎢᏃᎵᎪᎢ	ì:nohlgó:ɂi	You (1) and I usually understand it
ᎢᏙᎵᎪᎢ	ì:dohlgó:ɂi	All of us usually understand it
ᎤᏬᎵᏍᏗ	ù:wo:hlísdi	For him to understand it; For him to recognize him
ᏍᏗᎪᎲᎢ	sdi:go:hv̌:ɂi	He saw you both a while ago; You both saw it a while ago
ᎩᏂᏥ	gini:ji	Your one's and my mother
ᏣᏘᏗ	jatdi	For you (1) to say it
ᎤᎾᏘᏗ	ù:natdi	For them to say it
ᏚᏅᏙɂᎢ	du:nhtó:ɂi	He usually knows things
ᎤᏅᏔ	u:nhta	He knows something
ᏕᎩᏲᏏᏌ	dé:gi:yò:sǐ:sā	All of us were recently hungry
ᏍᏗᎪᏩᏔ	sdi:gò:wahta	Let you both see it
ᏍᎩᏥ	sgiji	You one, my mother
ᏚᏅᏛɂᎢ	du:nhtv̌:ɂi	He knew things a while ago
ᎤᏛᏅᎢ	u:dv:hnv̌:ɂi	He said a while ago
ᏩᎭᏗᏔ	wa:dǐ:ta	Let him drink something
ᎩᏂᎾᎣᎢ	gini:náó:ɂi	You (1) and I usually have something flexible
ᏦᎵᏨᎢ	johljv̌:ɂi	You (1) understood it a while ago; He recognized you (1) a while ago
ᏕᏦᎵᏨᎢ	dé:johljv̌:ɂi	You all understood things a while ago
ᏕᏍᏙᎵᏨᎢ	de:sdohljv̌:ɂi	You both understood things a while ago
ᎢᏥᎪᎲᎢ	ì:ji:go:hv̌:ɂi	He saw you all a while ago; You all saw it a while ago
ᏍᏗᏙᏓ	sdi:do:da	Your two's father
ᏗᎩᏲᏏᏌ	dì:gi:yò:sǐ:sa	Let all of us be hungry
ᎢᏓᏗᏍᎪᎢ	ì:dadǐ:sgó:ɂi	All of us are often saying
ꮪꮹᏟᏌᏅᎢ	du:wá:hli:sahnv̌:ɂi	He gathered things a while ago
ᎩᏂᎾᎥᎢ	gini:náv̌:ɂi	You (1) and I had something flexible a while ago
ᏍᏗᎮᏍᏗ	sdi:hé:sdi	You both will be having something solid
ᎢᏥᎪᏩᏔ	ì:ji:gò:wahta	Let you all see it
ᏍᏛᏙᏓ	sdv:do:da	I, your two's father
ᎦᏚᎩᏍᎪᎢ	gaɂdǔ:gî:sgó:ɂi	I am usually drinking something alcoholic
ᏍᏗᎸᏒᎢ	sdi:lv̂:sv̌:ɂi	You both climbed it a while ago
ᎩᏂᏁᎮᏍᏗ	gini:ne:hé:sdi	You (1) and I will be having a liquid
ᏬᏥᏍᏗᎦ	wò:ji:sdǐ:ga	Let them and me eat something rod shaped
ᏬᏍᏗᏍᏗᎦ	wò:sdi:sdǐ:ga	Let him and me eat something rod shaped
ᏬᎪᎵᎩ	wò:gohlgi	Let him recognize them and me; Let them and me be recognized
ᏬᎩᏃᎵᎩ	wò:ginohlgi	Let him recognize him and me; Let him and me be recognized
ᏣᏙᏓ	jado:da	xHe, your one's father
ᏥᏔᏕᎬᎦ	jitade:gv̀:gā	I was recently thirsty
ᎤᏘᏗ	utdi	For him to say it
ᎠᏆᏛᏅᎢ	à:gwadv:hnv̌:ɂi	I said a while ago
ᎣᎦᏛᏅᎢ	ò:gadv:hnv̌:ɂi	They and I said a while ago
ᎣᎩᎾᏛᏅᎢ	ò:ginadv:hnv̌:ɂi	He and I said a while ago
ᏍᏗᎸᏍᏗ	sdi:lv̀:sdi	For you both to climb it
ᎯᎭᏗᏔ	ha:dǐ:ta	Let you (1) drink something
ᎩᏂᏍᏗᎬᎢ	ginì:sdí:gv̌:ɂi	You (1) and I ate something rod shaped a while ago
ᏣᎾᎣᎢ	janáó:ɂi	You (1) usually have something flexible
ᎢᏥᎮᏍᏗ	ì:ji:hé:sdi	You all will be having something solid
ᏧᎵᎢ	ju:liɂi	His friends
ᎠᏆᏘᏗ	à:gwatdi	For me to say it
ᎣᎦᏘᏗ	ò:gatdi	For them and me to say it
ᎣᎩᎾᏘᏗ	ò:ginatdi	For him and me to say it
ᎠᏂᏍᏗᎩᎠ	à:nì:sdǐ:gíɂa	They are eating something rod shaped
ᎢᏥᎸᏒᎢ	ì:ji:lv̂:sv̌:ɂi	You all climbed it a while ago
ᎤᏗᏔᏍᏗ	u:di:tasdi	For him to drink something
ᎢᏂᏍᏗᎩᎠ	ì:nì:sdǐ:gíɂa	You (1) and I are eating something rod shaped
ᎯᎭᏗᏔ	ha:dǐ:tā	You (1) recently drank something
ᎢᏗᏍᏗᎩᎠ	ì:dì:sdǐ:gíɂa	All of us are eating something rod shaped
ᎩᏂᏟᏐᏗ	ginì:hlǐ:sóhdi	For you (1) and me to gather something
ᎤᏂᏍᏗᎬᎢ	ù:nì:sdí:gv̌:ɂi	They ate something rod shaped a while ago
ᏣᎾᎥᎢ	janáv̌:ɂi	You (1) had something flexible a while ago
ᏍᏗᎾᎠ	sdi:náɂa	You both have something flexible
ᏫᎪᎵᎩ	wì:gohlgi	Let him recognize all of us
ᎠᎩᏥ	agiji	xShe, my mother
ᎤᏲᏏᏍᎪᎢ	ù:yó:si:sgó:ɂi	He usually is hungry
ᎢᎦᏛᏅᎢ	ì:gadv:hnv̌:ɂi	All of us said a while ago
ᏕᏣᏚᎩᏒᎢ	dé:jàtǔ:gî:sv̌:ɂi	You all drank alcoholic drinks a while ago
ᎢᏥᎸᏍᏗ	ì:ji:lv̀:sdi	For you all to climb it
ᏕᏍᏓᏚᎩᏒᎢ	de:sdàtǔ:gî:sv̌:ɂi	You both drank alcoholic drinks a while ago
ᎠᏂᎭᏗᏔ	à:na:dǐ:tā	They recently drank something
ᎢᏂᎭᏗᏔ	ì:na:dǐ:ta	Let you (1) and me drink something
ᏣᏁᎮᏍᏗ	jane:hé:sdi	You (1) will be having a liquid
ᎢᏗᎭᏗᏔ	ì:da:dǐ:ta	Let all of us drink something
ᏍᏗᏁᎰᎢ	sdi:ne:hó:ɂi	You both usually have a liquid
ᎢᎦᎵᎢ	ì:ga:liɂi	You one and I, our friend; You two and I, our friend; You all and I, our friend; You all and I, friends; You all, my friends
ᎤᏲᏏᏍᎬᎢ	ù:yó:si:sgv̌:ɂi	He was hungry a while ago
ᎠᏔᏕᎬᎦ	atade:gv̀:gā	He was recently thirsty
ᏓᏂᏔᏕᎬᎦ	dà:ni:tade:gv̀:gā	They were recently thirsty
ᎢᎦᏘᏗ	ì:gatdi	For all of us to say it
ᎢᏂᎭᏗᏔ	ì:na:dǐ:tā	You (1) and I recently drank something
ᏕᏣᏚᎩᎠ	dé:jàtǔ:gía	You all are drinking alcoholic drinks
ᎢᏗᎭᏗᏔ	ì:da:dǐ:tā	All of us recently drank something
ᎣᎩᎾᎣᎢ	ò:gi:náó:ɂi	They and I usually have something flexible
ᎣᎩᏂᎾᎣᎢ	ò:gini:náó:ɂi	He and I usually have something flexible
ᎢᏥᎾᎠ	ì:ji:náɂa	You all have something flexible
ᎤᏃᎵᏨᎢ	ù:nohljv̌:ɂi	They understood it a while ago; They recognized him a while ago
ᎩᏃᎵᏨᎢ	ginohljv̌:ɂi	You (1) and I understood it a while ago; He recognized you (1) and me a while ago
ᎢᏍᎩᏙᏓ	ì:sgi:do:da	You one, their and my father
ᎤᏲᏏᏐᏗ	ù:yò:sǐ:sóhdi	For him to be hungry
ᏩᎩᏲᏏᏌ	wà:giyò:sǐ:sa	Let me be hungry
ᏕᏂᏔᏕᎬᎦ	dé:ni:tade:gv̀:gā	You (1) and I were recently thirsty
ᏕᏗᏔᏕᎬᎦ	dé:di:tade:gv̀:gā	All of us were recently thirsty
ᏕᎩᏂᏲᏏᏌ	de:gini:yò:sǐ:sā	You (1) and I were recently hungry
ᏕᏥᎾᎡᏍᏗ	dé:ji:náé:sdi	You all will be having flexible things
ᏕᏍᏗᎾᎡᏍᏗ	de:sdi:náé:sdi	You both will be having flexible things
ᏩᏂᎭᏗᏔ	wà:na:dǐ:ta	Let them drink something
ᎢᏥᏁᎰᎢ	ì:ji:ne:hó:ɂi	You all usually have a liquid
ᎢᏣᎵᎢ	ì:ja:liɂi	You two, your friend; You all, your friend; You all, friends
ᏗᏂᏔᏕᎬᎦ	dì:ni:tade:gv̀:ga	Let you (1) and me be thirsty
ᏫᏥᏯᎦ	wijiyaga	Let me eat something flexible
ᏗᏗᏔᏕᎬᎦ	dì:di:tade:gv̀:ga	Let all of us be thirsty
ᏚᏂᏲᏏᎭ	dù:ni:yó:siha	They are hungry
ᎢᎩᎾᎣᎢ	ì:gi:náó:ɂi	All of us usually have something flexible
ᏍᏗᏍᏗᎦ	sdi:sdǐ:ga	Let you both eat something rod shaped
ᏕᏍᎩᏂᎧᎰᎢ	de:sgini:kahó:ɂi	You (1) or both usually have us both
ᎤᎪᏩᏛᏗ	ù:gowhtv́hdi	For him to see him; For him to see it
ᎣᎩᏂᏥ	o:gini:ji	His and my mother
ᎯᏔᏕᎬᎦ	hitade:gv̀:ga	Let you (1) be thirsty
ᎣᎩᏍᏗᎬᎢ	ò:gì:sdí:gv̌:ɂi	They and I ate something rod shaped a while ago
ᎣᎩᏂᏍᏗᎬᎢ	ò:ginì:sdí:gv̌:ɂi	He and I ate something rod shaped a while ago
ᎢᎩᎾᎥᎢ	ì:gi:náv̌:ɂi	All of us had something flexible a while ago
ᏍᏗᏍᏗᎦ	sdi:sdǐ:gā	You both recently ate something rod shaped
ᎣᎦᎵᎢ	ò:ga:liɂi	He and I, our friend; They and I, our friend; They and I, friends; They, my friends
ᎯᏔᏕᎬᎦ	hitade:gv̀:gā	You (1) were recently thirsty
ᏗᎩᏂᏁᏗ	digini:nehdi	For you (1) and me to have a liquid
ᎤᏍᏗᎩᏍᏗ	ù:sdǐ:gî:sdi	For him to eat something rod shaped
ᏕᏥᏍᏗᎩᎠ	dé:jì:sdǐ:gíɂa	You all are eating rod shaped things
ᏣᏍᏗᎬᎢ	jàsdí:gv̌:ɂi	You (1) ate something rod shaped a while ago
ᎢᏥᏍᏗᎦ	ì:ji:sdǐ:ga	Let you all eat something rod shaped
ᎣᏦᎵᎪᎢ	ò:johlgó:ɂi	They and I usually understand it
ᎣᏍᏙᎵᎪᎢ	ò:sdohlgó:ɂi	He and I usually understand it
ᎤᎾᎵᎢ	ù:na:liɂi	His friend; Their friend; They, friends
ᎤᏔᏕᎪᏗ	ù:tadě:gô:di	For him to be thirsty
ᏥᎠᏗᏍᎪᎢ	jigà:tahó:ɂi	I usually know how
ᏩᏔᏕᎬᎦ	watade:gv̀:ga	Let him be thirsty
ᏕᏥᎭᏗᏔ	dé:ja:dǐ:tā	You all recently drank drinks
ᏕᏍᏗᎭᏗᏔ	de:sda:dǐ:tā	You both recently drank drinks
ᎢᎩᏍᏗᎬᎢ	ì:gì:sdí:gv̌:ɂi	All of us ate something rod shaped a while ago
ᎢᏥᏍᏗᎦ	ì:ji:sdǐ:gā	You all recently ate something rod shaped
ᎠᏂᎪᏩᏘᎭ	à:ni:gowhtíha	They are seeing him; They are seeing it
ᎥᏍᎩᎾ	v̀:sgina	That, Those; They, Them; He, Him
ᎤᏔᏕᎩᎠ	ù:tade:gí:ɂa	He is thirsty
ᏕᏧᏗᏔᎲᎢ	dé:jù:di:tahv̌:ɂi	You all drank drinks a while ago
ᏕᏍᏚᏗᏔᎲᎢ	de:sdù:di:tahv̌:ɂi	You both drank drinks a while ago
ᏣᏟᏐᏗ	jàhlǐ:sóhdi	For you (1) to gather something
ᏍᎩᎾᎦᏙᏍᏙᏗ	sginagà:tǒ:sdóhdi	For you (1) or both to look at us both
ᎣᎪᎵᏨᎢ	ò:gohljv̌:ɂi	They and I understood it a while ago; He recognized them and me a while ago; They and I were recognized a while ago
ᏥᎪᏩᏘᎭ	jigowhtíha	I am seeing it
ᎦᏥᏙᏓ	gaji:do:da	I, their father
ᏙᎦᏅᏔ	dò:ganhta	They and I know something; They and I know things
ᏧᏗᏔᏍᏗ	ja:di:tasdi	For you (1) to drink something
ᎠᎩᎾᎣᎢ	à:gináó:ɂi	I usually have something flexible
ᎠᎪᏩᏘᎭ	agowhtíha	He is seeing him; He is seeing it
ᎢᏂᎪᏩᏘᎭ	ì:ni:gowhtíha	You (1) and I are seeing it
ᎢᏗᎪᏩᏘᎭ	ì:di:gowhtíha	All of us are seeing it
ᎩᏂᏙᏓ	gini:do:da	Your one's and my father
ᏙᎩᏲᏏᎭ	dò:gi:yó:siha	They and I are hungry
ᏙᎩᏂᏲᏏᎭ	dò:gini:yó:siha	He and I are hungry
ᎠᏍᏗᎩᏍᎪᎢ	àsdǐ:gî:sgó:ɂi	He usually is eating something rod shaped
ᏧᏗᏔᎲᎢ	jù:di:tahv̌:ɂi	You (1) drank something a while ago
ᎯᏚᎲᏍᎪᎢ	hídu:hvsgó:ɂi	You (1) are usually baking something
ᎢᎪᎵᏨᎢ	ì:gohljv̌:ɂi	All of us understood it a while ago; He recognized all of us a while ago
ᏍᎩᏂᏥ	sgini:ji	You one, his and my mother
ᏥᏍᏗᎩᏍᎪᎢ	jìsdǐ:gî:sgó:ɂi	I am usually eating something rod shaped
ᏍᎩᏙᏓ	sgido:da	You one, my father
ᏕᎩᏲᏏᎭ	dé:gi:yó:siha	All of us are hungry
ᎯᏍᏗᎩᏍᎪᎢ	hìsdǐ:gî:sgó:ɂi	You (1) usually are eating something rod shaped
ᎠᎩᏍᏗᎬᎢ	à:gìsdí:gv̌:ɂi	I ate something rod shaped a while ago
ᏕᏍᎩᏂᎧᎮᏍᏗ	de:sgini:kahé:sdi	You (1) or both will be having us both
ᎤᏂᎪᏩᏛᏗ	ù:ni:gowhtv́hdi	For them to see him; For them to see it
ᏍᏓᎵᎢ	sda:liɂi	You one, your friend; You two, friends
ᏫᏗᏂᏔᏕᎬᎦ	widìni:tade:gv̀:ga	Let them be thirsty
ᎤᏂᎾᎡᏍᏗ	ù:ni:náé:sdi	They will be having something flexible
ᏫᎦᎭᏗᏔ	wiga:dǐ:ta	Let me drink something
ᏍᏙᎵᏍᏗ	sdo:hlísdi	For you both to understand it; For him to recognize you both
ᎤᏬᎵᏨᎢ	ù:wohljv̌:ɂi	He understood it a while ago; He recognized him a while ago
ᎩᏂᎪᏩᏛᏗ	gini:gowhtv́hdi	For him to see you (1) and me; For you (1) and me to see it
ᏦᎦᎵᎢ	jò:ga:liɂi	They and I, our friends
ᏫᏥᏔᏕᎬᎦ	wijitade:gv̀:ga	Let me be thirsty
ᎤᏂᏍᏗᎩᏍᏗ	ù:ni:sdǐ:gî:sdi	For them to eat something rod shaped
ᏣᎪᏩᏛᏗ	jagowhtv́hdi	For you (1) to see it; For him to see you (1)
ᏧᎾᎵᎢ	jù:na:liɂi	Their friends
ᎩᏂᏍᏗᎩᏍᏗ	gini:sdǐ:gî:sdi	For you (1) and me to eat something rod shaped
ᏣᎾᎡᏍᏗ	janáé:sdi	You (1) will be having something flexible
ᎢᏦᎵᏍᏗ	ì:jo:hlísdi	For you all to understand it; For him to recognize you all
ᎠᎪᏩᏘᏍᎪᎢ	agowhtǐ:sgóɂi	He is often seeing him; He is often seeing it
ᎯᎪᏩᏘᏍᎪᎢ	higowhtǐ:sgóɂi	You (1) are often seeing it
ᏥᎪᏩᏘᏍᎪᎢ	jigowhtǐ:sgóɂi	I am often seeing it
ᎠᎩᏙᏓ	agido:da	xHe, my father
ᎤᏄᏗᏔᏍᏗ	ù:na:di:tasdi	For them to drink something
ᎣᎩᏂᏙᏓ	o:gini:do:da	His and my father
ᎤᏄᏗᏔᎲᎢ	ù:nù:di:tahv̌:ɂi	They drank something a while ago
ᎩᏄᏗᏔᏍᏗ	gina:di:tasdi	For you (1) and me to drink something
ᎣᏥᎪᏩᏛᏗ	ò:ji:gowhtv́hdi	For them and me to see him
ᎣᏍᏗᎪᏩᏛᏗ	ò:sdi:gowhtv́hdi	For him and me to see him
ᎩᎾᎵᎢ	gina:liɂi	You one and I, friends; You one, my friend
ᏚᏂᏲᏏᏍᎪᎢ	dù:ni:yó:si:sgó:ɂi	They usually are hungry
ᎩᏄᏗᏔᎲᎢ	ginù:di:tahv̌:ɂi	You (1) and I drank something a while ago
ᏍᎩᏂᏙᏓ	sgini:do:da	You one, his and my father
ᎤᏔᏕᎦᏅᎢ	ù:tade:gâ:nv̌:ɂi	He was thirsty a while ago
ᏚᏂᏲᏏᏍᎬᎢ	dù:ni:yó:si:sgv̌:ɂi	They were hungry a while ago
ᏕᏥᏲᏏᏌ	dé:ji:yò:sǐ:sā	You all were recently hungry
ᏣᏟᏌᏅᎢ	jáhli:sahnv̌:ɂi	You (1) gathered something a while ago
ᎣᏍᏗᏍᏗᎩᎠ	ò:sdì:sdǐ:gíɂa	He and I are eating something rod shaped
ᎣᎩᎪᏩᏛᏗ	ò:gi:gowhtv́hdi	For him to see them and me; For them and me to see it; For them and me to be seen
ᎣᎩᏂᎪᏩᏛᏗ	ò:gini:gowhtv́hdi	For him to see him and me; For him and me to see it; For him and me to be seen
ᏗᎦᎵᎢ	diga:liɂi	You all and I, our friends
ᎠᏊᏗᏔᏍᏗ	à:gwa:di:tasdi	For me to drink something
ᏣᏍᏗᎩᏍᏗ	tssdǐ:gî:sdi	For you (1) to eat something rod shaped
ᎣᏥᎭᏗᏔ	ò:ja:dǐ:tā	They and I recently drank something
ᎣᏍᏗᎭᏗᏔ	ò:sda:dǐ:tā	He and I recently drank something
ꭴꮹᏟᏐᏗ	ù:wà:hlǐ:sóhdi	For him to gather something
ᏗᏣᎵᎢ	dija:liɂi	You all, your friends
ᏚᏂᏔᏕᎩᎠ	dù:ni:tade:gí:ɂa	They are thirsty
ᏣᏔᏕᎪᏗ	tstadě:gô:di	For you (1) to be thirsty
ᏗᏥᏲᏏᏌ	dì:ji:yò:sǐ:sa	Let you all be hungry
ᎠᏊᏗᏔᎲᎢ	à:gwù:di:tahv̌:ɂi	I drank something a while ago
ᎣᎩᏍᏗᎩᏍᏗ	ò:gi:sdǐ:gî:sdi	For them and me to eat something rod shaped
ᎣᎩᏂᏍᏗᎩᏍᏗ	ò:gini:sdǐ:gî:sdi	For him and me to eat something rod shaped
ᏍᏗᎾᎣᎢ	sdi:náó:ɂi	You both usually have something flexible
ᎢᎩᎪᏩᏛᏗ	ì:gi:gowhtv́hdi	For him to see all of us; For all of us to see it
ᏗᏆᎵᎢ	dìgwa:liɂi	My friends
ᏧᏂᏲᏏᏐᏗ	jù:ni:yò:sǐ:sóhdi	For them to be hungry
ᏙᏥᏔᏕᎬᎦ	dò:ji:tade:gv̀:gā	They and I were recently thirsty
ᏙᏍᏗᏔᏕᎬᎦ	dò:sdi:tade:gv̀:gā	He and I were recently thirsty
ᏗᏣᎵᎢ	dijaliɂi	You one, your friends
ᏧᏂᏔᏕᎪᏗ	jù:ni:tadě:gô:di	For them to be thirsty
ᏗᎩᏂᏲᏏᏌ	digini:yò:sǐ:sa	Let you (1) and me be hungry
ᎣᎫᏗᏔᏍᏗ	ò:ga:di:tasdi	For them and me to drink something
ᎤᏭᏗᏔᎲᎢ	ù:wù:di:tahv̌:ɂi	He drank something a while ago
ᎣᎩᏄᏗᏔᏍᏗ	ò:gina:di:tasdi	For him and me to drink something
ᎢᎩᏍᏗᎩᏍᏗ	ì:gi:sdǐ:gî:sdi	For all of us to eat something rod shaped
ᎣᎩᎾᎵᎢ	ò:gina:liɂi	He and I, friends; He, my friend
ᎣᎫᏗᏔᎲᎢ	ò:gù:di:tahv̌:ɂi	They and I drank something a while ago
ᏬᏥᎭᏗᏔ	wò:ja:dǐ:ta	Let them and me drink something
ᎣᎩᏄᏗᏔᎲᎢ	ò:ginù:di:tahv̌:ɂi	He and I drank something a while ago
ᏬᏍᏗᎭᏗᏔ	wò:sda:dǐ:ta	Let him and me drink something
ᏗᏍᏓᎵᎢ	disda:liɂi	You two, your friends
ᏣᏔᏕᎦᏅᎢ	tstade:gâ:nv̌:ɂi	You (1) were thirsty a while ago
ᏚᎾᏅᏖᏍᏗ	dù:nanhté:sdi	They will be knowing something; They will be knowing things
ᎢᎫᏗᏔᏍᏗ	ì:ga:di:tasdi	For all of us to drink something
ᏍᏗᏍᏗᎬᎢ	sdì:sdí:gv̌:ɂi	You both ate something rod shaped a while ago
ᏦᎩᎾᎵᎢ	jò:gina:liɂi	He and I, our friends
ᎢᎫᏗᏔᎲᎢ	ì:gù:di:tahv̌:ɂi	All of us drank something a while ago
ᎣᏣᎦᏙᏍᏙᏗ	ò:jagà:tǒ:sdóhdi	For them and me to look at him
ᎣᏍᏓᎦᏙᏍᏙᏗ	ò:sdagà:tǒ:sdóhdi	For him and me to look at him
ᎠᎩᎪᏩᏛᏗ	à:gigowhtv́hdi	For me to see it; For him to see me
ᏗᎩᎾᎵᎢ	digina:liɂi	You one and I, our friends
ᏙᎩᏔᏕᎩᎠ	dò:gi:tade:gí:ɂa	They and I are thirsty
ᏙᎩᏂᏔᏕᎩᎠ	dò:gini:tade:gí:ɂa	He and I are thirsty
ꭴꮹᏟᏌᏅᎢ	ù:wá:hli:sahnv̌:ɂi	He gathered something a while ago
ᎠᎩᏍᏗᎩᏍᏗ	à:ksdǐ:gî:sdi	For me to eat something rod shaped
ᎢᏥᎾᎣᎢ	ì:ji:náó:ɂi	You all usually have something flexible
ᏍᏙᎵᏨᎢ	sdohljv̌:ɂi	You both understood it a while ago; He recognized you both a while ago
ᏦᎩᏔᏕᎪᏗ	jò:gi:tadě:gô:di	For them and me to be thirsty
ᎠᎩᏔᏕᎪᏗ	à:ktadě:gô:di	For me to be thirsty
ᏕᎩᏔᏕᎩᎠ	dé:gi:tade:gí:ɂa	All of us are thirsty
ᏕᏍᏗᏲᏏᏌ	de:sdi:yò:sǐ:sā	You both were recently hungry
ᎠᎩᏔᏕᎩᎠ	à:ktade:gí:ɂa	I am thirsty
ᏗᎩᏔᏕᎪᏗ	dì:gi:tadě:gô:di	For all of us to be thirsty
ᏕᎩᏂᏔᏕᎩᎠ	de:gini:tade:gí:ɂa	You (1) and I are thirsty
ᏗᏍᏗᏁᏗ	disdi:nehdi	For you both to have a liquid
ᎣᏣᎦᏙᏍᏔᏅᎢ	ò:jà:gà:tǒ:stánv̌:ɂi	They and I looked at him a while ago
ᎣᏍᏓᎦᏙᏍᏔᏅᎢ	ò:sdà:gà:tǒ:stánv̌:ɂi	He and I looked at him a while ago
ᏙᎩᏂᏔᏕᎦᏅᎢ	dò:gini:tade:gâ:nv̌:ɂi	He and I were thirsty a while ago
ᎢᏦᎵᏨᎢ	ì:johljv̌:ɂi	You all understood it a while ago; He recognized you all a while ago
ᏕᎩᏔᏕᎦᏅᎢ	dé:gi:tade:gâ:nv̌:ɂi	All of us were thirsty a while ago
ᏫᏦᏥᏔᏕᎬᎦ	wijò:ji:tade:gv̀:ga	Let them and me be thirsty
ᏫᏦᏍᏗᏔᏕᎬᎦ	wijò:sdi:tade:gv̀:ga	Let him and me be thirsty
ᏕᎩᏂᏔᏕᎦᏅᎢ	de:gini:tade:gâ:nv̌:ɂi	You (1) and I were thirsty a while ago
ᎠᎩᏔᏕᎩᏍᎪᎢ	à:ktade:gí:sgó:ɂi	I am usually thirsty
ᎠᎩᎪᏩᏘᏍᎪᎢ	à:gigowhtǐ:sgóɂi	He is often seeing me
ᏍᏗᏍᏗᎩᏍᏗ	sdi:sdǐ:gî:sdi	For you both to eat something rod shaped
ᏍᏗᎭᏗᏔ	sda:dǐ:ta	Let you both drink something
ᏍᏗᎭᏗᏔ	sda:dǐ:tā	You both recently drank something
ᏍᏚᏗᏔᏍᏗ	sda:di:tasdi	For you both to drink something
ᏍᏚᏗᏔᎲᎢ	sdù:di:tahv̌:ɂi	You both drank something a while ago
ᎢᏥᏍᏗᎩᏍᏗ	ì:ji:sdǐ:gî:sdi	For you all to eat something rod shaped
ᏕᏍᏗᏲᏏᎭ	de:sdi:yó:siha	You both are hungry
ᏗᏍᏗᏲᏏᏌ	disdi:yò:sǐ:sa	Let you both be hungry
ᎢᏥᎭᏗᏔ	ì:ja:dǐ:ta	Let you all drink something
ᎢᏥᎭᏗᏔ	ì:ja:dǐ:tā	You all recently drank something
ᎢᏧᏗᏔᏍᏗ	ì:ja:di:tasdi	For you all to drink something
ᎢᏧᏗᏔᎲᎢ	ì:jù:di:tahv̌:ɂi	You all drank something a while ago
ᏕᏍᏗᏔᏕᎩᎠ	de:sdi:tade:gí:ɂa	You both are thirsty
ᏕᏍᏗᏔᏕᎬᎦ	de:sdi:tade:gv̀:gā	You both were recently thirsty
ᏕᏥᏔᏕᎩᎠ	dé:tstade:gí:ɂa	You all are thirsty
ᏕᏥᏔᏕᎬᎦ	dé:tstade:gv̀:gā	You all were recently thirsty
ᏗᏥᏔᏕᎪᏗ	dì:tstadě:gô:di	For you all to be thirsty
ᏗᏥᏔᏕᎬᎦ	dì:tstade:gv̀:ga	Let you all be thirsty
ᏕᏍᏗᏔᏕᎦᏅᎢ	de:sdi:tade:gâ:nv̌:ɂi	You both were thirsty a while ago
ᏗᏍᏗᏔᏕᎬᎦ	disdi:tade:gv̀:ga	Let you both be thirsty
ᏕᏍᏗᏔᏕᎩᏍᎪᎢ	de:sdi:tade:gí:sgó:ɂi	You both are usually thirsty
